,Year,NOC,region,Bronze,Gold,Silver,Total
0,1896,AUS,Australia,1,2,0,3
1,1896,USA,USA,2,11,7,20
2,1896,SWE,Sweden,0,0,0,0
3,1896,SUI,Switzerland,0,1,2,3
4,1896,HUN,Hungary,3,2,1,6
5,1896,GRE,Greece,20,10,18,48
6,1896,ITA,Italy,0,0,0,0
7,1896,GBR,UK,3,3,3,9
8,1896,FRA,France,2,5,4,11
9,1896,DEN,Denmark,3,1,2,6
10,1896,AUT,Austria,2,2,1,5
11,1896,GER,Germany,2,25,5,32
12,1900,NED,Netherlands,16,3,8,27
13,1900,IRI,Iran,0,0,0,0
14,1900,ITA,Italy,0,3,2,5
15,1900,LUX,Luxembourg,0,1,0,1
16,1900,MEX,Mexico,3,0,0,3
17,1900,NOR,Norway,3,0,6,9
18,1900,SWE,Sweden,1,3,0,4
19,1900,PER,Peru,0,0,0,0
20,1900,ROU,Romania,0,0,0,0
21,1900,RUS,Russia,0,0,0,0
22,1900,SUI,Switzerland,1,16,4,21
23,1900,IND,India,0,0,2,2
24,1900,USA,USA,17,30,16,63
25,1900,NZL,New Zealand,0,1,0,1
26,1900,HUN,Hungary,2,1,2,5
27,1900,GBR,UK,15,58,34,107
28,1900,GRE,Greece,0,0,0,0
29,1900,ARG,Argentina,0,0,0,0
30,1900,AUS,Australia,3,3,0,6
31,1900,AUT,Austria,3,0,3,6
32,1900,BEL,Belgium,13,6,24,43
33,1900,HAI,Haiti,0,1,0,1
34,1900,BRA,Brazil,0,0,0,0
35,1900,CAN,Canada,1,1,0,2
36,1900,BOH,Czech Republic,2,0,1,3
37,1900,CUB,Cuba,0,1,1,2
38,1900,DEN,Denmark,2,4,3,9
39,1900,ESP,Spain,0,2,0,2
40,1900,FRA,France,82,50,93,225
41,1900,GER,Germany,11,14,20,45
42,1900,COL,Colombia,0,0,1,1
43,1904,ITA,Italy,0,0,0,0
44,1904,USA,USA,125,128,141,138
45,1904,SUI,Switzerland,2,1,0,3
46,1904,RSA,South Africa,0,0,0,0
47,1904,NOR,Norway,0,2,0,2
48,1904,NFL,Canada,0,0,0,0
49,1904,HUN,Hungary,1,2,1,4
50,1904,AUT,Austria,1,2,1,4
51,1904,GER,Germany,7,4,5,16
52,1904,GBR,UK,0,1,1,2
53,1904,FRA,France,0,0,2,2
54,1904,CUB,Cuba,0,5,0,5
55,1904,CAN,Canada,12,27,9,48
56,1904,GRE,Greece,1,1,0,2
57,1904,AUS,Australia,1,0,3,4
58,1906,HUN,Hungary,3,5,5,13
59,1906,ITA,Italy,27,21,8,56
60,1906,NED,Netherlands,5,0,1,6
61,1906,SWE,Sweden,14,2,5,21
62,1906,SUI,Switzerland,1,8,3,12
63,1906,GER,Germany,6,14,10,30
64,1906,TUR,Turkey,0,0,0,0
65,1906,USA,USA,6,12,6,24
66,1906,NOR,Norway,0,20,5,25
67,1906,GBR,UK,8,9,22,39
68,1906,GRE,Greece,30,24,48,102
69,1906,FIN,Finland,1,2,1,4
70,1906,EGY,Egypt,0,0,0,0
71,1906,DEN,Denmark,1,14,19,34
72,1906,CRT,Greece,0,0,0,0
73,1906,CAN,Canada,0,1,1,2
74,1906,BOH,Czech Republic,3,0,0,3
75,1906,BEL,Belgium,6,2,3,11
76,1906,AUT,Austria,3,3,3,9
77,1906,AUS,Australia,3,0,0,3
78,1906,FRA,France,28,20,16,64
79,1908,ISL,Iceland,0,0,0,0
80,1908,ITA,Italy,0,2,6,8
81,1908,NED,Netherlands,16,0,0,16
82,1908,NOR,Norway,3,7,32,42
83,1908,USA,USA,15,34,16,65
84,1908,RUS,Russia,0,1,2,3
85,1908,SUI,Switzerland,0,0,0,0
86,1908,SWE,Sweden,18,48,18,84
87,1908,HUN,Hungary,6,7,7,20
88,1908,RSA,South Africa,0,1,1,2
89,1908,GRE,Greece,1,0,3,4
90,1908,GER,Germany,6,4,11,21
91,1908,GBR,UK,90,147,131,112
92,1908,FRA,France,23,12,5,40
93,1908,FIN,Finland,28,1,1,30
94,1908,DEN,Denmark,3,0,14,17
95,1908,CAN,Canada,30,14,8,52
96,1908,BOH,Czech Republic,6,0,0,6
97,1908,BEL,Belgium,8,1,24,33
98,1908,AUT,Austria,1,0,0,1
99,1908,ARG,Argentina,0,0,0,0
100,1908,ANZ,Australia,2,15,2,19
101,1912,NED,Netherlands,26,0,0,26
102,1912,NOR,Norway,34,40,6,80
103,1912,POL,Poland,0,0,0,0
104,1912,POR,Portugal,0,0,0,0
105,1912,RSA,South Africa,0,5,2,7
106,1912,TUR,Turkey,0,0,0,0
107,1912,SRB,Serbia,0,0,0,0
108,1912,SUI,Switzerland,0,2,0,2
109,1912,SWE,Sweden,25,103,62,190
110,1912,LUX,Luxembourg,0,0,0,0
111,1912,USA,USA,36,46,25,107
112,1912,RUS,Russia,9,0,5,14
113,1912,ITA,Italy,2,22,1,25
114,1912,JPN,Japan,0,0,0,0
115,1912,HUN,Hungary,3,10,17,30
116,1912,ISL,Iceland,0,0,0,0
117,1912,AUT,Austria,5,0,9,14
118,1912,BEL,Belgium,11,7,1,19
119,1912,BOH,Czech Republic,0,0,0,0
120,1912,CAN,Canada,3,3,2,8
121,1912,CHI,Chile,0,0,0,0
122,1912,ANZ,Australia,3,5,2,10
123,1912,FIN,Finland,22,9,40,71
124,1912,FRA,France,5,10,11,26
125,1912,GBR,UK,59,47,64,170
126,1912,GER,Germany,23,11,19,53
127,1912,GRE,Greece,1,1,0,2
128,1912,DEN,Denmark,33,5,49,87
129,1920,LUX,Luxembourg,0,0,1,1
130,1920,MON,Monaco,0,0,0,0
131,1920,NED,Netherlands,25,15,10,50
132,1920,NOR,Norway,27,58,52,137
133,1920,NZL,New Zealand,1,0,0,1
134,1920,POR,Portugal,0,0,0,0
135,1920,SWE,Sweden,64,52,38,154
136,1920,SUI,Switzerland,21,6,2,29
137,1920,TCH,Czech Republic,10,0,0,10
138,1920,USA,USA,38,111,45,194
139,1920,YUG,Serbia,0,0,0,0
140,1920,JPN,Japan,0,0,3,3
141,1920,RSA,South Africa,6,3,12,21
142,1920,ITA,Italy,8,67,9,84
143,1920,DEN,Denmark,1,26,44,71
144,1920,GRE,Greece,0,0,5,5
145,1920,IND,India,0,0,0,0
146,1920,ARG,Argentina,0,0,0,0
147,1920,AUS,Australia,1,0,6,7
148,1920,BRA,Brazil,5,1,1,7
149,1920,CAN,Canada,3,10,3,16
150,1920,CHI,Chile,0,0,0,0
151,1920,BEL,Belgium,66,57,65,188
152,1920,EGY,Egypt,0,0,0,0
153,1920,ESP,Spain,0,0,23,23
154,1920,EST,Estonia,0,1,2,3
155,1920,FIN,Finland,17,21,14,52
156,1920,FRA,France,57,13,71,141
157,1920,GBR,UK,17,52,42,111
158,1924,POL,Poland,1,0,4,5
159,1924,LUX,Luxembourg,0,1,1,2
160,1924,MEX,Mexico,0,0,0,0
161,1924,MON,Monaco,1,0,0,1
162,1924,NEP,Nepal,0,1,0,1
163,1924,NOR,Norway,9,18,12,39
164,1924,NZL,New Zealand,1,0,0,1
165,1924,PHI,Philippines,0,0,0,0
166,1924,LTU,Lithuania,0,0,0,0
167,1924,POR,Portugal,4,0,0,4
168,1924,TUR,Turkey,0,0,0,0
169,1924,RSA,South Africa,1,1,1,3
170,1924,RUS,Russia,0,0,0,0
171,1924,SUI,Switzerland,22,22,25,69
172,1924,SWE,Sweden,43,8,30,81
173,1924,TCH,Czech Republic,5,1,4,10
174,1924,URU,Uruguay,0,14,0,14
175,1924,USA,USA,50,98,46,194
176,1924,YUG,Serbia,0,2,0,2
177,1924,LAT,Latvia,0,0,0,0
178,1924,ROU,Romania,16,0,0,16
179,1924,JPN,Japan,1,0,0,1
180,1924,NED,Netherlands,18,8,1,27
181,1924,IRL,Ireland,1,0,1,2
182,1924,AUS,Australia,2,4,5,11
183,1924,AUT,Austria,1,3,4,8
184,1924,BEL,Belgium,11,3,30,44
185,1924,BRA,Brazil,0,0,0,0
186,1924,BUL,Bulgaria,0,0,0,0
187,1924,CAN,Canada,1,9,19,29
188,1924,CHI,Chile,0,0,0,0
189,1924,CUB,Cuba,0,0,0,0
190,1924,DEN,Denmark,3,2,9,14
191,1924,ECU,Ecuador,0,0,0,0
192,1924,ARG,Argentina,2,5,3,10
193,1924,ESP,Spain,0,0,0,0
194,1924,EST,Estonia,4,1,1,6
195,1924,FIN,Finland,18,28,21,67
196,1924,FRA,France,32,37,51,120
197,1924,ITA,Italy,21,25,5,51
198,1924,GBR,UK,30,31,34,95
199,1924,GRE,Greece,0,1,0,1
200,1924,HAI,Haiti,5,0,0,5
201,1924,HUN,Hungary,8,2,12,22
202,1924,IND,India,0,7,0,7
203,1924,EGY,Egypt,0,0,0,0
204,1928,PAN,Panama,0,0,0,0
205,1928,NZL,New Zealand,0,1,0,1
206,1928,NOR,Norway,6,10,8,24
207,1928,LUX,Luxembourg,0,1,0,1
208,1928,MON,Monaco,0,0,0,0
209,1928,MLT,Malta,0,0,0,0
210,1928,MEX,Mexico,0,0,0,0
211,1928,PHI,Philippines,1,0,0,1
212,1928,NED,Netherlands,8,20,29,57
213,1928,POL,Poland,15,2,3,20
214,1928,TCH,Czech Republic,3,2,12,17
215,1928,ROU,Romania,0,0,0,0
216,1928,RSA,South Africa,5,1,0,6
217,1928,SUI,Switzerland,16,16,10,42
218,1928,SWE,Sweden,23,9,21,53
219,1928,TUR,Turkey,0,0,0,0
220,1928,URU,Uruguay,0,17,0,17
221,1928,USA,USA,19,53,30,102
222,1928,YUG,Serbia,10,1,1,12
223,1928,ZIM,Zimbabwe,0,0,0,0
224,1928,LTU,Lithuania,0,0,0,0
225,1928,POR,Portugal,6,0,0,6
226,1928,LAT,Latvia,0,0,0,0
227,1928,JPN,Japan,1,2,6,9
228,1928,ITA,Italy,26,24,22,72
229,1928,ARG,Argentina,5,3,18,26
230,1928,AUS,Australia,1,1,2,4
231,1928,AUT,Austria,4,3,4,11
232,1928,BEL,Belgium,5,0,1,6
233,1928,BUL,Bulgaria,0,0,0,0
234,1928,CAN,Canada,21,19,5,45
235,1928,CUB,Cuba,0,0,0,0
236,1928,DEN,Denmark,4,6,5,15
237,1928,EGY,Egypt,1,2,1,4
238,1928,ESP,Spain,0,3,0,3
239,1928,CHI,Chile,0,0,1,1
240,1928,FIN,Finland,10,10,9,29
241,1928,EST,Estonia,6,2,1,9
242,1928,IND,India,0,14,0,14
243,1928,HUN,Hungary,0,10,11,21
244,1928,HAI,Haiti,0,0,1,1
245,1928,IRL,Ireland,0,1,0,1
246,1928,GER,Germany,46,21,15,82
247,1928,GBR,UK,25,7,27,59
248,1928,FRA,France,14,14,24,52
249,1928,GRE,Greece,0,0,0,0
250,1932,PER,Peru,0,0,0,0
251,1932,JPN,Japan,4,10,17,31
252,1932,LAT,Latvia,0,0,1,1
253,1932,LUX,Luxembourg,0,0,0,0
254,1932,YUG,Serbia,0,0,0,0
255,1932,MON,Monaco,0,0,0,0
256,1932,NED,Netherlands,1,2,10,13
257,1932,NOR,Norway,3,3,4,10
258,1932,NZL,New Zealand,0,0,2,2
259,1932,PHI,Philippines,3,0,0,3
260,1932,VEN,Venezuela,0,0,0,0
261,1932,POR,Portugal,0,0,0,0
262,1932,ROU,Romania,0,0,0,0
263,1932,RSA,South Africa,3,2,0,5
264,1932,SUI,Switzerland,0,0,3,3
265,1932,SWE,Sweden,12,14,9,35
266,1932,TCH,Czech Republic,2,1,3,6
267,1932,TUR,Turkey,0,0,0,0
268,1932,URU,Uruguay,1,0,0,1
269,1932,USA,USA,64,91,68,223
270,1932,ITA,Italy,18,21,38,77
271,1932,POL,Poland,14,3,4,21
272,1932,IRL,Ireland,0,2,0,2
273,1932,MEX,Mexico,0,0,2,2
274,1932,HUN,Hungary,10,20,5,35
275,1932,IND,India,0,15,0,15
276,1932,ARG,Argentina,0,3,1,4
277,1932,AUS,Australia,1,3,1,5
278,1932,AUT,Austria,3,2,2,7
279,1932,BEL,Belgium,1,0,0,1
280,1932,BRA,Brazil,0,0,0,0
281,1932,CAN,Canada,29,16,14,59
282,1932,CHN,China,0,0,0,0
283,1932,COL,Colombia,0,0,0,0
284,1932,CUB,Cuba,0,0,0,0
285,1932,BUL,Bulgaria,0,0,0,0
286,1932,ESA,El Salvador,0,0,0,0
287,1932,DEN,Denmark,4,0,7,11
288,1932,GUA,Guatemala,0,0,0,0
289,1932,GRE,Greece,0,0,0,0
290,1932,GER,Germany,21,10,26,57
291,1932,GBR,UK,14,9,12,35
292,1932,HAI,Haiti,0,0,0,0
293,1932,FIN,Finland,17,6,9,32
294,1932,EST,Estonia,0,0,0,0
295,1932,ESP,Spain,1,0,0,1
296,1932,FRA,France,6,28,8,42
297,1936,NZL,New Zealand,0,1,0,1
298,1936,LAT,Latvia,1,0,1,2
299,1936,LIE,Liechtenstein,0,0,0,0
300,1936,LUX,Luxembourg,0,0,0,0
301,1936,MEX,Mexico,16,0,0,16
302,1936,MLT,Malta,0,0,0,0
303,1936,MON,Monaco,0,0,0,0
304,1936,NED,Netherlands,21,9,7,37
305,1936,NOR,Norway,18,8,20,46
306,1936,PER,Peru,0,0,0,0
307,1936,USA,USA,30,53,29,112
308,1936,POL,Poland,6,0,6,12
309,1936,POR,Portugal,3,0,0,3
310,1936,ROU,Romania,0,0,1,1
311,1936,RSA,South Africa,0,0,1,1
312,1936,SUI,Switzerland,24,9,29,62
313,1936,SWE,Sweden,23,9,13,45
314,1936,TCH,Czech Republic,1,5,12,18
315,1936,TUR,Turkey,1,1,0,2
316,1936,URU,Uruguay,0,0,0,0
317,1936,ITA,Italy,5,37,34,76
318,1936,YUG,Serbia,0,0,1,1
319,1936,PHI,Philippines,1,0,0,1
320,1936,ISL,Iceland,0,0,0,0
321,1936,JPN,Japan,10,9,4,23
322,1936,HUN,Hungary,17,25,1,43
323,1936,IND,India,0,19,0,19
324,1936,AFG,Afghanistan,0,0,0,0
325,1936,ARG,Argentina,4,5,2,11
326,1936,AUS,Australia,1,0,0,1
327,1936,AUT,Austria,9,7,44,60
328,1936,BEL,Belgium,14,0,0,14
329,1936,BOL,Boliva,0,0,0,0
330,1936,BRA,Brazil,0,0,0,0
331,1936,BUL,Bulgaria,0,0,0,0
332,1936,CAN,Canada,9,1,25,35
333,1936,CHI,Chile,0,0,0,0
334,1936,BER,Bermuda,0,0,0,0
335,1936,COL,Colombia,0,0,0,0
336,1936,GRE,Greece,0,0,0,0
337,1936,CHN,China,0,0,0,0
338,1936,GER,Germany,61,97,73,231
339,1936,GBR,UK,12,24,17,53
340,1936,FIN,Finland,16,12,8,36
341,1936,FRA,France,19,13,13,45
342,1936,ESP,Spain,0,0,0,0
343,1936,EGY,Egypt,2,2,1,5
344,1936,DEN,Denmark,3,0,3,6
345,1936,CRC,Costa Rica,0,0,0,0
346,1936,EST,Estonia,3,2,2,7
347,1948,PER,Peru,0,1,0,1
348,1948,NZL,New Zealand,0,0,0,0
349,1948,PAN,Panama,2,0,0,2
350,1948,PAK,Pakistan,0,0,0,0
351,1948,NOR,Norway,17,7,7,31
352,1948,MEX,Mexico,4,4,1,9
353,1948,MYA,Myanmar,0,0,0,0
354,1948,MON,Monaco,0,0,0,0
355,1948,MLT,Malta,0,0,0,0
356,1948,LUX,Luxembourg,0,0,0,0
357,1948,POL,Poland,1,1,0,2
358,1948,NED,Netherlands,32,8,2,42
359,1948,POR,Portugal,3,0,2,5
360,1948,VEN,Venezuela,0,0,0,0
361,1948,ROU,Romania,0,0,0,0
362,1948,RSA,South Africa,2,2,2,6
363,1948,SRI,Sri Lanka,0,0,1,1
364,1948,SUI,Switzerland,25,9,30,64
365,1948,SWE,Sweden,33,37,18,88
366,1948,SYR,Syria,0,0,0,0
367,1948,TCH,Czech Republic,3,14,20,37
368,1948,TTO,Trinidad,0,0,1,1
369,1948,TUR,Turkey,2,6,4,12
370,1948,URU,Uruguay,2,0,1,3
371,1948,USA,USA,41,93,34,168
372,1948,YUG,Serbia,0,0,16,16
373,1948,LIE,Liechtenstein,0,0,0,0
374,1948,PUR,Puerto Rico,1,0,0,1
375,1948,LIB,Lebanon,0,0,0,0
376,1948,PHI,Philippines,0,0,0,0
377,1948,JAM,Jamaica,0,1,2,3
378,1948,AFG,Afghanistan,0,0,0,0
379,1948,ARG,Argentina,1,3,7,11
380,1948,AUS,Australia,5,2,9,16
381,1948,AUT,Austria,8,3,5,16
382,1948,BEL,Belgium,8,7,6,21
383,1948,BER,Bermuda,0,0,0,0
384,1948,BRA,Brazil,10,0,0,10
385,1948,CAN,Canada,7,13,2,22
386,1948,CHI,Chile,0,0,0,0
387,1948,CHN,China,0,0,0,0
388,1948,COL,Colombia,0,0,0,0
389,1948,CUB,Cuba,0,0,2,2
390,1948,DEN,Denmark,27,7,17,51
391,1948,EGY,Egypt,1,2,2,5
392,1948,BUL,Bulgaria,0,0,0,0
393,1948,KOR,South Korea,2,0,0,2
394,1948,ESP,Spain,0,0,3,3
395,1948,ITA,Italy,14,22,32,68
396,1948,ISL,Iceland,0,0,0,0
397,1948,IRQ,Iraq,0,0,0,0
398,1948,IRL,Ireland,1,0,0,1
399,1948,IND,India,0,20,0,20
400,1948,IRI,Iran,1,0,0,1
401,1948,GUY,Guyana,0,0,0,0
402,1948,GRE,Greece,0,0,0,0
403,1948,GBR,UK,14,7,42,63
404,1948,FRA,France,26,28,23,77
405,1948,FIN,Finland,10,18,14,42
406,1948,HUN,Hungary,22,15,27,64
407,1952,POL,Poland,1,1,2,4
408,1952,NZL,New Zealand,2,1,0,3
409,1952,PHI,Philippines,0,0,0,0
410,1952,PAN,Panama,0,0,0,0
411,1952,PAK,Pakistan,0,0,0,0
412,1952,NOR,Norway,6,12,14,32
413,1952,LIB,Lebanon,1,0,1,2
414,1952,NED,Netherlands,0,0,21,21
415,1952,MYA,Myanmar,0,0,0,0
416,1952,MON,Monaco,0,0,0,0
417,1952,MEX,Mexico,0,0,1,1
418,1952,LUX,Luxembourg,0,1,0,1
419,1952,POR,Portugal,2,0,0,2
420,1952,NGR,Nigeria,0,0,0,0
421,1952,PUR,Puerto Rico,0,0,0,0
422,1952,VNM,Vietnam,0,0,0,0
423,1952,RSA,South Africa,4,2,8,14
424,1952,YUG,Serbia,0,4,20,24
425,1952,KOR,South Korea,2,0,0,2
426,1952,VEN,Venezuela,1,0,0,1
427,1952,USA,USA,29,87,48,164
428,1952,URU,Uruguay,14,0,0,14
429,1952,URS,Russia,19,36,62,117
430,1952,ROU,Romania,2,1,1,4
431,1952,TUR,Turkey,1,2,0,3
432,1952,THA,Thailand,0,0,0,0
433,1952,TCH,Czech Republic,10,11,4,25
434,1952,SWE,Sweden,46,23,24,93
435,1952,SUI,Switzerland,18,2,19,39
436,1952,SRI,Sri Lanka,0,0,0,0
437,1952,SAA,Germany,0,0,0,0
438,1952,TTO,Trinidad,2,0,0,2
439,1952,JPN,Japan,2,1,9,12
440,1952,LIE,Liechtenstein,0,0,0,0
441,1952,ITA,Italy,16,18,22,56
442,1952,DEN,Denmark,5,3,1,9
443,1952,CUB,Cuba,0,0,0,0
444,1952,CHN,China,0,0,0,0
445,1952,CHI,Chile,0,0,4,4
446,1952,CAN,Canada,1,17,3,21
447,1952,BRA,Brazil,2,1,0,3
448,1952,EGY,Egypt,1,0,0,1
449,1952,BER,Bermuda,0,0,0,0
450,1952,BAH,Bahamas,0,0,0,0
451,1952,AUT,Austria,4,2,5,11
452,1952,AUS,Australia,11,7,2,20
453,1952,ARG,Argentina,2,2,2,6
454,1952,AHO,Curacao,0,0,0,0
455,1952,JAM,Jamaica,0,5,3,8
456,1952,BEL,Belgium,0,5,3,8
457,1952,ESP,Spain,0,0,1,1
458,1952,BUL,Bulgaria,1,0,0,1
459,1952,FRA,France,18,14,9,41
460,1952,ISR,Israel,0,0,0,0
461,1952,FIN,Finland,31,14,7,52
462,1952,ISL,Iceland,0,0,0,0
463,1952,IRL,Ireland,0,0,1,1
464,1952,IRI,Iran,4,0,3,7
465,1952,INA,Indonesia,0,0,0,0
466,1952,HUN,Hungary,34,53,17,104
467,1952,IND,India,1,14,0,15
468,1952,GUY,Guyana,0,0,0,0
469,1952,GUA,Guatemala,0,0,0,0
470,1952,GRE,Greece,0,0,0,0
471,1952,GHA,Ghana,0,0,0,0
472,1952,GER,Germany,28,8,16,52
473,1952,GBR,UK,26,4,2,32
474,1952,HKG,China,0,0,0,0
475,1956,PHI,Philippines,0,0,0,0
476,1956,NGR,Nigeria,0,0,0,0
477,1956,PER,Peru,0,0,0,0
478,1956,PAK,Pakistan,0,0,14,14
479,1956,NZL,New Zealand,0,3,0,3
480,1956,NOR,Norway,3,3,1,7
481,1956,NED,Netherlands,0,0,0,0
482,1956,LIB,Lebanon,0,0,0,0
483,1956,MYA,Myanmar,0,0,0,0
484,1956,MEX,Mexico,1,1,0,2
485,1956,MAL,Malaysia,0,0,0,0
486,1956,LUX,Luxembourg,0,0,0,0
487,1956,LIE,Liechtenstein,0,0,0,0
488,1956,LBR,Liberia,0,0,0,0
489,1956,POL,Poland,10,1,9,20
490,1956,NBO,Malaysia,0,0,0,0
491,1956,POR,Portugal,0,0,0,0
492,1956,VNM,Vietnam,0,0,0,0
493,1956,ROU,Romania,10,6,3,19
494,1956,KOR,South Korea,1,0,1,2
495,1956,YUG,Serbia,0,0,23,23
496,1956,VEN,Venezuela,0,0,0,0
497,1956,USA,USA,25,63,61,149
498,1956,URU,Uruguay,12,0,0,12
499,1956,URS,Russia,61,94,51,206
500,1956,UGA,Uganda,0,0,0,0
501,1956,PUR,Puerto Rico,0,0,0,0
502,1956,TUR,Turkey,2,3,2,7
503,1956,TPE,Taiwan,0,0,0,0
504,1956,THA,Thailand,0,0,0,0
505,1956,TCH,Czech Republic,1,1,5,7
506,1956,SWE,Sweden,15,16,18,49
507,1956,SUI,Switzerland,5,6,2,13
508,1956,SRI,Sri Lanka,0,0,0,0
509,1956,RSA,South Africa,7,0,0,7
510,1956,TTO,Trinidad,0,0,0,0
511,1956,KEN,Kenya,0,0,0,0
512,1956,BRA,Brazil,0,1,0,1
513,1956,JAM,Jamaica,0,0,0,0
514,1956,DEN,Denmark,1,1,4,6
515,1956,COL,Colombia,0,0,0,0
516,1956,CHI,Chile,2,0,2,4
517,1956,CAN,Canada,23,5,11,39
518,1956,CAM,Cambodia,0,0,0,0
519,1956,BUL,Bulgaria,14,1,3,18
520,1956,BOL,Boliva,0,0,0,0
521,1956,BER,Bermuda,0,0,0,0
522,1956,BEL,Belgium,0,0,2,2
523,1956,BAH,Bahamas,2,0,0,2
524,1956,AUT,Austria,8,5,3,16
525,1956,AUS,Australia,26,28,13,67
526,1956,ARG,Argentina,1,0,1,2
527,1956,AFG,Afghanistan,0,0,0,0
528,1956,JPN,Japan,5,4,16,25
529,1956,EGY,Egypt,0,0,0,0
530,1956,ESP,Spain,0,0,0,0
531,1956,CUB,Cuba,0,0,0,0
532,1956,FIJ,Fiji,0,0,0,0
533,1956,ITA,Italy,10,28,17,55
534,1956,ISR,Israel,0,0,0,0
535,1956,ISL,Iceland,0,0,1,1
536,1956,IRL,Ireland,3,1,1,5
537,1956,IRI,Iran,1,2,2,5
538,1956,ETH,Ethiopia,0,0,0,0
539,1956,INA,Indonesia,0,0,0,0
540,1956,HUN,Hungary,16,30,20,66
541,1956,IND,India,0,17,0,17
542,1956,GUY,Guyana,0,0,0,0
543,1956,GRE,Greece,1,0,0,1
544,1956,GER,Germany,24,10,20,54
545,1956,GBR,UK,22,8,16,46
546,1956,FRA,France,13,7,13,33
547,1956,FIN,Finland,23,8,7,38
548,1956,HKG,China,0,0,0,0
549,1960,PUR,Puerto Rico,0,0,0,0
550,1960,PAK,Pakistan,1,13,0,14
551,1960,POR,Portugal,0,0,2,2
552,1960,POL,Poland,16,4,12,32
553,1960,PHI,Philippines,0,0,0,0
554,1960,PER,Peru,0,0,0,0
555,1960,PAN,Panama,0,0,0,0
556,1960,ZIM,Zimbabwe,0,0,0,0
557,1960,MAR,Morocco,0,0,1,1
558,1960,NOR,Norway,0,5,6,11
559,1960,NGR,Nigeria,0,0,0,0
560,1960,NED,Netherlands,3,0,2,5
561,1960,MYA,Myanmar,0,0,0,0
562,1960,MON,Monaco,0,0,0,0
563,1960,MLT,Malta,0,0,0,0
564,1960,MEX,Mexico,1,0,0,1
565,1960,RHO,Zimbabwe,0,0,0,0
566,1960,NZL,New Zealand,1,2,0,3
567,1960,ROU,Romania,11,3,1,15
568,1960,VNM,Vietnam,0,0,0,0
569,1960,SMR,San Marino,0,0,0,0
570,1960,MAL,Malaysia,0,0,0,0
571,1960,YUG,Serbia,0,16,1,17
572,1960,WIF,Trinidad,5,0,0,5
573,1960,VEN,Venezuela,1,0,0,1
574,1960,USA,USA,25,100,27,152
575,1960,URU,Uruguay,0,0,0,0
576,1960,URS,Russia,73,68,70,211
577,1960,UGA,Uganda,0,0,0,0
578,1960,RSA,South Africa,2,0,1,3
579,1960,UAR,Syria,1,0,1,2
580,1960,TUN,Tunisia,0,0,0,0
581,1960,TPE,Taiwan,0,0,1,1
582,1960,THA,Thailand,0,0,0,0
583,1960,TCH,Czech Republic,11,4,8,23
584,1960,SWE,Sweden,5,7,4,16
585,1960,SUI,Switzerland,6,2,6,14
586,1960,SUD,Sudan,0,0,0,0
587,1960,SRI,Sri Lanka,0,0,0,0
588,1960,TUR,Turkey,0,7,2,9
589,1960,LUX,Luxembourg,0,0,0,0
590,1960,IND,India,0,0,13,13
591,1960,LIB,Lebanon,0,0,0,0
592,1960,ETH,Ethiopia,0,1,0,1
593,1960,ESP,Spain,14,0,0,14
594,1960,DEN,Denmark,4,2,17,23
595,1960,CUB,Cuba,0,0,0,0
596,1960,COL,Colombia,0,0,0,0
597,1960,CHI,Chile,0,0,0,0
598,1960,CAN,Canada,1,3,26,30
599,1960,BRA,Brazil,13,0,0,13
600,1960,BER,Bermuda,0,0,0,0
601,1960,BEL,Belgium,2,0,2,4
602,1960,BAH,Bahamas,0,0,0,0
603,1960,AUT,Austria,3,2,4,9
604,1960,AUS,Australia,11,11,24,46
605,1960,ARG,Argentina,1,0,3,4
606,1960,AHO,Curacao,0,0,0,0
607,1960,AFG,Afghanistan,0,0,0,0
608,1960,LIE,Liechtenstein,0,0,0,0
609,1960,FIJ,Fiji,0,0,0,0
610,1960,FIN,Finland,9,6,4,19
611,1960,BUL,Bulgaria,3,1,3,7
612,1960,GBR,UK,15,2,11,28
613,1960,LBR,Liberia,0,0,0,0
614,1960,FRA,France,8,1,6,15
615,1960,KOR,South Korea,0,0,0,0
616,1960,KEN,Kenya,0,0,0,0
617,1960,JPN,Japan,12,9,10,31
618,1960,ITA,Italy,35,36,18,89
619,1960,ISL,Iceland,0,0,0,0
620,1960,IRQ,Iraq,1,0,0,1
621,1960,IRL,Ireland,0,0,0,0
622,1960,ISR,Israel,0,0,0,0
623,1960,INA,Indonesia,0,0,0,0
624,1960,HUN,Hungary,37,13,16,66
625,1960,HKG,China,0,0,0,0
626,1960,HAI,Haiti,0,0,0,0
627,1960,GUY,Guyana,0,0,0,0
628,1960,GRE,Greece,0,3,0,3
629,1960,IRI,Iran,3,0,1,4
630,1960,GHA,Ghana,0,0,1,1
631,1960,GER,Germany,23,38,37,98
632,1964,PHI,Philippines,0,0,1,1
633,1964,NIG,Niger,0,0,0,0
634,1964,NOR,Norway,6,3,6,15
635,1964,NZL,New Zealand,2,4,0,6
636,1964,PER,Peru,0,0,0,0
637,1964,PAN,Panama,0,0,0,0
638,1964,NGR,Nigeria,1,0,0,1
639,1964,PAK,Pakistan,0,0,16,16
640,1964,NEP,Nepal,0,0,0,0
641,1964,LUX,Luxembourg,0,0,0,0
642,1964,MYA,Myanmar,0,0,0,0
643,1964,MON,Monaco,0,0,0,0
644,1964,MLI,Mali,0,0,0,0
645,1964,MGL,Mongolia,0,0,0,0
646,1964,MEX,Mexico,1,0,0,1
647,1964,MAR,Morocco,0,0,0,0
648,1964,MAD,Madagascar,0,0,0,0
649,1964,LIE,Liechtenstein,0,0,0,0
650,1964,POL,Poland,23,10,13,46
651,1964,NED,Netherlands,16,6,11,33
652,1964,POR,Portugal,0,0,0,0
653,1964,VNM,Vietnam,0,0,0,0
654,1964,PUR,Puerto Rico,0,0,0,0
655,1964,ZIM,Zimbabwe,0,0,0,0
656,1964,ZAM,Zambia,0,0,0,0
657,1964,YUG,Serbia,2,2,11,15
658,1964,LIB,Lebanon,0,0,0,0
659,1964,VEN,Venezuela,0,0,0,0
660,1964,USA,USA,42,96,39,177
661,1964,URU,Uruguay,1,0,0,1
662,1964,URS,Russia,60,90,71,221
663,1964,UGA,Uganda,0,0,0,0
664,1964,TUR,Turkey,1,2,3,6
665,1964,TUN,Tunisia,1,0,1,2
666,1964,TTO,Trinidad,5,0,1,6
667,1964,TPE,Taiwan,0,0,0,0
668,1964,THA,Thailand,0,0,0,0
669,1964,TCH,Czech Republic,29,5,37,71
670,1964,TAN,Tanzania,0,0,0,0
671,1964,SWE,Sweden,9,9,25,43
672,1964,SUI,Switzerland,1,1,4,6
673,1964,SRI,Sri Lanka,0,0,0,0
674,1964,SEN,Senegal,0,0,0,0
675,1964,ROU,Romania,10,2,4,16
676,1964,PRK,North Korea,0,0,1,1
677,1964,LBR,Liberia,0,0,0,0
678,1964,MAS,Malaysia,0,0,0,0
679,1964,KEN,Kenya,1,0,0,1
680,1964,COL,Colombia,0,0,0,0
681,1964,CMR,Cameroon,0,0,0,0
682,1964,CIV,Ivory Coast,0,0,0,0
683,1964,CHI,Chile,0,0,0,0
684,1964,CHA,Chad,0,0,0,0
685,1964,CGO,Republic of Congo,0,0,0,0
686,1964,CAN,Canada,2,6,4,12
687,1964,CAM,Cambodia,0,0,0,0
688,1964,BUL,Bulgaria,2,3,5,10
689,1964,CRC,Costa Rica,0,0,0,0
690,1964,BRA,Brazil,12,0,0,12
691,1964,BEL,Belgium,1,2,0,3
692,1964,BAH,Bahamas,0,2,0,2
693,1964,AUT,Austria,3,5,9,17
694,1964,AUS,Australia,30,8,6,44
695,1964,ARG,Argentina,0,0,1,1
696,1964,ALG,Algeria,0,0,0,0
697,1964,AHO,Curacao,0,0,0,0
698,1964,AFG,Afghanistan,0,0,0,0
699,1964,KOR,South Korea,1,0,2,3
700,1964,BER,Bermuda,0,0,0,0
701,1964,CUB,Cuba,0,0,1,1
702,1964,BOL,Boliva,0,0,0,0
703,1964,DOM,Dominican Republic,0,0,0,0
704,1964,JPN,Japan,25,32,5,62
705,1964,DEN,Denmark,4,7,1,12
706,1964,JAM,Jamaica,0,0,0,0
707,1964,ITA,Italy,17,14,30,61
708,1964,ISR,Israel,0,0,0,0
709,1964,ISL,Iceland,0,0,0,0
710,1964,IRL,Ireland,1,0,0,1
711,1964,IRI,Iran,2,0,0,2
712,1964,IND,India,0,15,0,15
713,1964,HUN,Hungary,7,42,7,56
714,1964,IRQ,Iraq,0,0,0,0
715,1964,GUY,Guyana,0,0,0,0
716,1964,GRE,Greece,0,0,0,0
717,1964,GHA,Ghana,1,0,0,1
718,1964,GER,Germany,53,25,48,126
719,1964,GBR,UK,5,6,19,30
720,1964,FRA,France,17,4,17,38
721,1964,FIN,Finland,7,6,7,20
722,1964,ETH,Ethiopia,0,1,0,1
723,1964,HKG,China,0,0,0,0
724,1964,ESP,Spain,0,0,0,0
725,1964,EGY,Egypt,0,0,0,0
726,1968,PAR,Paraguay,0,0,0,0
727,1968,MYA,Myanmar,0,0,0,0
728,1968,NCA,Nicaragua,0,0,0,0
729,1968,NED,Netherlands,4,9,10,23
730,1968,NGR,Nigeria,0,0,0,0
731,1968,PAK,Pakistan,0,13,0,13
732,1968,NOR,Norway,2,15,11,28
733,1968,NZL,New Zealand,2,5,0,7
734,1968,PAN,Panama,0,0,0,0
735,1968,MON,Monaco,0,0,0,0
736,1968,NIG,Niger,0,0,0,0
737,1968,MLT,Malta,0,0,0,0
738,1968,LBA,Libya,0,0,0,0
739,1968,MGL,Mongolia,3,0,1,4
740,1968,MEX,Mexico,3,3,3,9
741,1968,MAS,Malaysia,0,0,0,0
742,1968,MAR,Morocco,0,0,0,0
743,1968,MAD,Madagascar,0,0,0,0
744,1968,LUX,Luxembourg,0,0,0,0
745,1968,LIE,Liechtenstein,0,0,0,0
746,1968,LIB,Lebanon,0,0,0,0
747,1968,KUW,Kuwait,0,0,0,0
748,1968,KOR,South Korea,1,0,1,2
749,1968,PER,Peru,0,0,0,0
750,1968,MLI,Mali,0,0,0,0
751,1968,PHI,Philippines,0,0,0,0
752,1968,VEN,Venezuela,0,1,0,1
753,1968,POR,Portugal,0,0,0,0
754,1968,KEN,Kenya,2,3,7,12
755,1968,ZAM,Zambia,0,0,0,0
756,1968,YUG,Serbia,2,13,14,29
757,1968,VNM,Vietnam,0,0,0,0
758,1968,USA,USA,36,100,37,173
759,1968,URU,Uruguay,0,0,0,0
760,1968,URS,Russia,69,91,69,229
761,1968,UGA,Uganda,1,0,1,2
762,1968,TUR,Turkey,0,2,0,2
763,1968,TUN,Tunisia,1,1,0,2
764,1968,TTO,Trinidad,0,0,0,0
765,1968,TPE,Taiwan,1,0,0,1
766,1968,THA,Thailand,0,0,0,0
767,1968,TAN,Tanzania,0,0,0,0
768,1968,SYR,Syria,0,0,0,0
769,1968,SWE,Sweden,7,7,11,25
770,1968,SUR,Suriname,0,0,0,0
771,1968,SUI,Switzerland,17,0,5,22
772,1968,SUD,Sudan,0,0,0,0
773,1968,SRI,Sri Lanka,0,0,0,0
774,1968,SMR,San Marino,0,0,0,0
775,1968,SLE,Sierra Leone,0,0,0,0
776,1968,SEN,Senegal,0,0,0,0
777,1968,ROU,Romania,11,5,9,25
778,1968,PUR,Puerto Rico,0,0,0,0
779,1968,POL,Poland,30,5,2,37
780,1968,JPN,Japan,22,16,25,63
781,1968,TCH,Czech Republic,16,8,26,50
782,1968,ITA,Italy,20,13,8,41
783,1968,CUB,Cuba,0,0,10,10
784,1968,CRC,Costa Rica,0,0,0,0
785,1968,COL,Colombia,0,0,0,0
786,1968,COD,Democratic Republic of the Congo,0,0,0,0
787,1968,CMR,Cameroon,0,0,1,1
788,1968,CIV,Ivory Coast,0,0,0,0
789,1968,CHI,Chile,0,0,0,0
790,1968,CHA,Chad,0,0,0,0
791,1968,CAN,Canada,22,4,4,30
792,1968,CAF,Central African Republic,0,0,0,0
793,1968,BUL,Bulgaria,3,2,21,26
794,1968,DEN,Denmark,6,5,6,17
795,1968,BRA,Brazil,3,0,1,4
796,1968,BIZ,Belize,0,0,0,0
797,1968,BER,Bermuda,0,0,0,0
798,1968,BEL,Belgium,2,0,1,3
799,1968,BAR,Barbados,0,0,0,0
800,1968,BAH,Bahamas,0,0,0,0
801,1968,AUT,Austria,7,3,10,20
802,1968,AUS,Australia,11,5,35,51
803,1968,ARG,Argentina,2,0,0,2
804,1968,ALG,Algeria,0,0,0,0
805,1968,AHO,Curacao,0,0,0,0
806,1968,AFG,Afghanistan,0,0,0,0
807,1968,BOL,Boliva,0,0,0,0
808,1968,DOM,Dominican Republic,0,0,0,0
809,1968,JAM,Jamaica,0,0,1,1
810,1968,EGY,Egypt,0,0,0,0
811,1968,ECU,Ecuador,0,0,0,0
812,1968,ISV,"Virgin Islands, US",0,0,0,0
813,1968,ISR,Israel,0,0,0,0
814,1968,ISL,Iceland,0,0,0,0
815,1968,IRQ,Iraq,0,0,0,0
816,1968,IRL,Ireland,0,0,0,0
817,1968,IRI,Iran,2,2,1,5
818,1968,IND,India,16,0,0,16
819,1968,HUN,Hungary,29,32,20,81
820,1968,HON,Honduras,0,0,0,0
821,1968,HKG,China,0,0,0,0
822,1968,GUY,Guyana,0,0,0,0
823,1968,GUI,Guinea,0,0,0,0
824,1968,INA,Indonesia,0,0,0,0
825,1968,GUA,Guatemala,0,0,0,0
826,1968,ESP,Spain,0,0,0,0
827,1968,ETH,Ethiopia,0,1,1,2
828,1968,FIJ,Fiji,0,0,0,0
829,1968,FIN,Finland,6,2,4,12
830,1968,FRA,France,12,16,8,36
831,1968,ESA,El Salvador,0,0,0,0
832,1968,GBR,UK,5,9,5,19
833,1968,GDR,Germany,21,15,22,58
834,1968,GHA,Ghana,0,0,0,0
835,1968,GRE,Greece,1,0,0,1
836,1968,FRG,Germany,23,19,19,61
837,1972,NED,Netherlands,4,7,4,15
838,1972,NEP,Nepal,0,0,0,0
839,1972,NGR,Nigeria,1,0,0,1
840,1972,NIG,Niger,1,0,0,1
841,1972,NOR,Norway,11,4,10,25
842,1972,PAN,Panama,0,0,0,0
843,1972,PAK,Pakistan,0,0,15,15
844,1972,PAR,Paraguay,0,0,0,0
845,1972,PER,Peru,0,0,0,0
846,1972,PHI,Philippines,0,0,0,0
847,1972,NCA,Nicaragua,0,0,0,0
848,1972,NZL,New Zealand,1,9,4,14
849,1972,MYA,Myanmar,0,0,0,0
850,1972,LBR,Liberia,0,0,0,0
851,1972,MLT,Malta,0,0,0,0
852,1972,MLI,Mali,0,0,0,0
853,1972,MGL,Mongolia,0,0,1,1
854,1972,MEX,Mexico,0,0,1,1
855,1972,MAW,Malawi,0,0,0,0
856,1972,MAS,Malaysia,0,0,0,0
857,1972,MAR,Morocco,0,0,0,0
858,1972,MAD,Madagascar,0,0,0,0
859,1972,LUX,Luxembourg,0,0,0,0
860,1972,LIE,Liechtenstein,0,0,0,0
861,1972,LIB,Lebanon,0,0,1,1
862,1972,LES,Lesotho,0,0,0,0
863,1972,POL,Poland,11,28,8,47
864,1972,MON,Monaco,0,0,0,0
865,1972,POR,Portugal,0,0,0,0
866,1972,VNM,Vietnam,0,0,0,0
867,1972,PUR,Puerto Rico,0,0,0,0
868,1972,ZAM,Zambia,0,0,0,0
869,1972,YUG,Serbia,2,15,1,18
870,1972,KUW,Kuwait,0,0,0,0
871,1972,VEN,Venezuela,0,0,0,0
872,1972,USA,USA,46,72,77,195
873,1972,URU,Uruguay,0,0,0,0
874,1972,URS,Russia,63,143,53,3
875,1972,UGA,Uganda,0,1,1,2
876,1972,TUR,Turkey,0,0,1,1
877,1972,TUN,Tunisia,0,0,1,1
878,1972,TTO,Trinidad,0,0,0,0
879,1972,TPE,Taiwan,0,0,0,0
880,1972,TOG,Togo,0,0,0,0
881,1972,THA,Thailand,0,0,0,0
882,1972,TCH,Czech Republic,25,3,21,49
883,1972,TAN,Tanzania,0,0,0,0
884,1972,SYR,Syria,0,0,0,0
885,1972,SWZ,Swaziland,0,0,0,0
886,1972,SWE,Sweden,10,5,11,26
887,1972,SUR,Suriname,0,0,0,0
888,1972,SUI,Switzerland,7,7,11,25
889,1972,SUD,Sudan,0,0,0,0
890,1972,SRI,Sri Lanka,0,0,0,0
891,1972,SOM,Somalia,0,0,0,0
892,1972,SMR,San Marino,0,0,0,0
893,1972,SEN,Senegal,0,0,0,0
894,1972,ROU,Romania,27,3,10,40
895,1972,PRK,North Korea,13,1,1,15
896,1972,KSA,Saudi Arabia,0,0,0,0
897,1972,ITA,Italy,14,12,8,34
898,1972,KEN,Kenya,4,5,3,12
899,1972,CUB,Cuba,18,3,1,22
900,1972,CRC,Costa Rica,0,0,0,0
901,1972,COL,Colombia,2,0,1,3
902,1972,CMR,Cameroon,0,0,0,0
903,1972,CIV,Ivory Coast,0,0,0,0
904,1972,CHI,Chile,0,0,0,0
905,1972,CHA,Chad,0,0,0,0
906,1972,CGO,Republic of Congo,0,0,0,0
907,1972,CAN,Canada,9,0,3,12
908,1972,CAM,Cambodia,0,0,0,0
909,1972,BUR,Burkina Faso,0,0,0,0
910,1972,BUL,Bulgaria,6,6,10,22
911,1972,BRA,Brazil,2,0,0,2
912,1972,BOL,Boliva,0,0,0,0
913,1972,BIZ,Belize,0,0,0,0
914,1972,BER,Bermuda,0,0,0,0
915,1972,BEN,Benin,0,0,0,0
916,1972,BEL,Belgium,0,0,2,2
917,1972,BAR,Barbados,0,0,0,0
918,1972,BAH,Bahamas,0,0,0,0
919,1972,KOR,South Korea,0,0,1,1
920,1972,AUS,Australia,2,11,7,20
921,1972,ARG,Argentina,0,0,1,1
922,1972,ALG,Algeria,0,0,0,0
923,1972,ALB,Albania,0,0,0,0
924,1972,AHO,Curacao,0,0,0,0
925,1972,AFG,Afghanistan,0,0,0,0
926,1972,DEN,Denmark,0,1,0,1
927,1972,DOM,Dominican Republic,0,0,0,0
928,1972,AUT,Austria,4,1,3,8
929,1972,EGY,Egypt,0,0,0,0
930,1972,ECU,Ecuador,0,0,0,0
931,1972,JPN,Japan,9,30,20,59
932,1972,JAM,Jamaica,1,0,0,1
933,1972,ISR,Israel,0,0,0,0
934,1972,ISL,Iceland,0,0,0,0
935,1972,IRL,Ireland,0,0,0,0
936,1972,IRI,Iran,1,0,2,3
937,1972,IND,India,14,0,0,14
938,1972,INA,Indonesia,0,0,0,0
939,1972,HUN,Hungary,25,10,46,81
940,1972,HKG,China,0,0,0,0
941,1972,HAI,Haiti,0,0,0,0
942,1972,GUY,Guyana,0,0,0,0
943,1972,ISV,"Virgin Islands, US",0,0,0,0
944,1972,GRE,Greece,0,0,2,2
945,1972,GUA,Guatemala,0,0,0,0
946,1972,ESP,Spain,1,1,0,2
947,1972,ESA,El Salvador,0,0,0,0
948,1972,FIJ,Fiji,0,0,0,0
949,1972,FIN,Finland,7,3,10,20
950,1972,ETH,Ethiopia,2,0,0,2
951,1972,FRG,Germany,43,48,21,112
952,1972,GAB,Gabon,0,0,0,0
953,1972,GBR,UK,12,8,9,29
954,1972,GDR,Germany,69,35,67,171
955,1972,GHA,Ghana,1,0,0,1
956,1972,FRA,France,17,2,6,25
957,1976,PAR,Paraguay,0,0,0,0
958,1976,PAN,Panama,0,0,0,0
959,1976,PAK,Pakistan,16,0,0,16
960,1976,NZL,New Zealand,9,15,1,25
961,1976,NOR,Norway,1,5,10,16
962,1976,NEP,Nepal,0,0,0,0
963,1976,NED,Netherlands,15,1,4,20
964,1976,NCA,Nicaragua,0,0,0,0
965,1976,MON,Monaco,0,0,0,0
966,1976,MGL,Mongolia,0,0,1,1
967,1976,LIE,Liechtenstein,2,0,0,2
968,1976,MAS,Malaysia,0,0,0,0
969,1976,MAR,Morocco,0,0,0,0
970,1976,LUX,Luxembourg,0,0,0,0
971,1976,LIB,Lebanon,0,0,0,0
972,1976,KUW,Kuwait,0,0,0,0
973,1976,KSA,Saudi Arabia,0,0,0,0
974,1976,KOR,South Korea,15,1,1,17
975,1976,JPN,Japan,10,25,6,41
976,1976,PER,Peru,0,0,0,0
977,1976,MEX,Mexico,1,1,0,2
978,1976,PHI,Philippines,0,0,0,0
979,1976,TPE,Taiwan,0,0,0,0
980,1976,POL,Poland,26,18,29,73
981,1976,JAM,Jamaica,0,1,1,2
982,1976,YUG,Serbia,3,2,14,19
983,1976,VEN,Venezuela,0,0,1,1
984,1976,USA,USA,41,73,61,175
985,1976,URU,Uruguay,0,0,0,0
986,1976,URS,Russia,88,152,102,86
987,1976,TUR,Turkey,0,0,0,0
988,1976,TUN,Tunisia,0,0,0,0
989,1976,TTO,Trinidad,0,1,0,1
990,1976,PNG,Papua New Guinea,0,0,0,0
991,1976,THA,Thailand,1,0,0,1
992,1976,SWE,Sweden,2,9,1,12
993,1976,SUR,Suriname,0,0,0,0
994,1976,SUI,Switzerland,8,2,9,19
995,1976,SMR,San Marino,0,0,0,0
996,1976,SEN,Senegal,0,0,0,0
997,1976,ROU,Romania,23,4,28,55
998,1976,PUR,Puerto Rico,1,0,0,1
999,1976,PRK,North Korea,0,1,1,2
1000,1976,POR,Portugal,0,0,2,2
1001,1976,TCH,Czech Republic,9,2,23,34
1002,1976,ITA,Italy,5,3,27,35
1003,1976,INA,Indonesia,0,0,0,0
1004,1976,ISR,Israel,0,0,0,0
1005,1976,COL,Colombia,0,0,0,0
1006,1976,CMR,Cameroon,0,0,0,0
1007,1976,CIV,Ivory Coast,0,0,0,0
1008,1976,CHI,Chile,0,0,0,0
1009,1976,CAY,Cayman Islands,0,0,0,0
1010,1976,CAN,Canada,15,1,10,26
1011,1976,BUL,Bulgaria,18,8,13,39
1012,1976,BRA,Brazil,3,0,0,3
1013,1976,BOL,Boliva,0,0,0,0
1014,1976,CRC,Costa Rica,0,0,0,0
1015,1976,BIZ,Belize,0,0,0,0
1016,1976,BEL,Belgium,6,0,3,9
1017,1976,BAR,Barbados,0,0,0,0
1018,1976,BAH,Bahamas,0,0,0,0
1019,1976,AUT,Austria,4,2,2,8
1020,1976,AUS,Australia,8,0,15,23
1021,1976,ARG,Argentina,0,0,0,0
1022,1976,ANT,Antigua,0,0,0,0
1023,1976,AND,Andorra,0,0,0,0
1024,1976,ISV,"Virgin Islands, US",0,0,0,0
1025,1976,BER,Bermuda,1,0,0,1
1026,1976,CUB,Cuba,14,6,4,24
1027,1976,AHO,Curacao,0,0,0,0
1028,1976,DOM,Dominican Republic,0,0,0,0
1029,1976,DEN,Denmark,5,3,0,8
1030,1976,IRL,Ireland,0,0,0,0
1031,1976,IRI,Iran,1,0,1,2
1032,1976,IND,India,0,0,0,0
1033,1976,HUN,Hungary,35,14,6,55
1034,1976,ISL,Iceland,0,0,0,0
1035,1976,HKG,China,0,0,0,0
1036,1976,HAI,Haiti,0,0,0,0
1037,1976,GUA,Guatemala,0,0,0,0
1038,1976,HON,Honduras,0,0,0,0
1039,1976,GDR,Germany,56,114,57,227
1040,1976,ECU,Ecuador,0,0,0,0
1041,1976,GRE,Greece,0,0,0,0
1042,1976,ESP,Spain,0,0,6,6
1043,1976,FIJ,Fiji,0,0,0,0
1044,1976,EGY,Egypt,0,0,0,0
1045,1976,FIN,Finland,1,9,12,22
1046,1976,FRA,France,9,5,7,21
1047,1976,FRG,Germany,55,23,32,110
1048,1976,GBR,UK,11,7,15,33
1049,1980,NZL,New Zealand,0,0,0,0
1050,1980,NOR,Norway,9,1,5,15
1051,1980,NGR,Nigeria,0,0,0,0
1052,1980,NEP,Nepal,0,0,0,0
1053,1980,NED,Netherlands,6,1,3,10
1054,1980,NCA,Nicaragua,0,0,0,0
1055,1980,PER,Peru,0,0,0,0
1056,1980,MOZ,Mozambique,0,0,0,0
1057,1980,LES,Lesotho,0,0,0,0
1058,1980,MLI,Mali,0,0,0,0
1059,1980,MGL,Mongolia,2,0,2,4
1060,1980,MEX,Mexico,9,0,1,10
1061,1980,MAD,Madagascar,0,0,0,0
1062,1980,LUX,Luxembourg,0,0,0,0
1063,1980,LIE,Liechtenstein,0,2,2,4
1064,1980,LIB,Lebanon,1,0,0,1
1065,1980,POL,Poland,22,3,25,50
1066,1980,LBA,Libya,0,0,0,0
1067,1980,MLT,Malta,0,0,0,0
1068,1980,POR,Portugal,0,0,0,0
1069,1980,SWE,Sweden,29,6,8,43
1070,1980,PUR,Puerto Rico,0,0,0,0
1071,1980,ZIM,Zimbabwe,0,15,0,15
1072,1980,LAO,Laos,0,0,0,0
1073,1980,ZAM,Zambia,0,0,0,0
1074,1980,YUG,Serbia,17,13,27,57
1075,1980,VIE,Vietnam,0,0,0,0
1076,1980,VEN,Venezuela,0,0,1,1
1077,1980,USA,USA,2,24,4,30
1078,1980,URS,Russia,133,205,158,240
1079,1980,UGA,Uganda,0,0,1,1
1080,1980,PRK,North Korea,2,0,3,5
1081,1980,TTO,Trinidad,0,0,0,0
1082,1980,TAN,Tanzania,0,0,2,2
1083,1980,SYR,Syria,0,0,0,0
1084,1980,SUI,Switzerland,3,4,4,11
1085,1980,SRI,Sri Lanka,0,0,0,0
1086,1980,SMR,San Marino,0,0,0,0
1087,1980,SLE,Sierra Leone,0,0,0,0
1088,1980,SEY,Seychelles,0,0,0,0
1089,1980,SEN,Senegal,0,0,0,0
1090,1980,ROU,Romania,46,7,15,68
1091,1980,TCH,Czech Republic,17,17,18,52
1092,1980,KUW,Kuwait,0,0,0,0
1093,1980,MYA,Myanmar,0,0,0,0
1094,1980,JPN,Japan,0,0,1,1
1095,1980,CRC,Costa Rica,0,0,0,0
1096,1980,COL,Colombia,0,0,0,0
1097,1980,CMR,Cameroon,0,0,0,0
1098,1980,CHN,China,0,0,0,0
1099,1980,CGO,Republic of Congo,0,0,0,0
1100,1980,CAN,Canada,1,0,1,2
1101,1980,BUL,Bulgaria,39,8,44,91
1102,1980,BRA,Brazil,5,4,0,9
1103,1980,BOT,Botswana,0,0,0,0
1104,1980,BOL,Boliva,0,0,0,0
1105,1980,BEN,Benin,0,0,0,0
1106,1980,BEL,Belgium,0,1,0,1
1107,1980,AUT,Austria,4,4,5,13
1108,1980,AUS,Australia,5,6,2,13
1109,1980,ANG,Angola,0,0,0,0
1110,1980,AND,Andorra,0,0,0,0
1111,1980,ALG,Algeria,0,0,0,0
1112,1980,AFG,Afghanistan,0,0,0,0
1113,1980,KOR,South Korea,0,0,0,0
1114,1980,CUB,Cuba,5,8,7,20
1115,1980,CYP,Cyprus,0,0,0,0
1116,1980,ARG,Argentina,0,0,0,0
1117,1980,DOM,Dominican Republic,0,0,0,0
1118,1980,JOR,Jordan,0,0,0,0
1119,1980,DEN,Denmark,2,4,2,8
1120,1980,JAM,Jamaica,3,0,0,3
1121,1980,ITA,Italy,8,8,24,40
1122,1980,IRQ,Iraq,0,0,0,0
1123,1980,IRL,Ireland,1,0,2,3
1124,1980,IND,India,0,16,0,16
1125,1980,HUN,Hungary,40,8,15,63
1126,1980,GUY,Guyana,1,0,0,1
1127,1980,GUI,Guinea,0,0,0,0
1128,1980,ISL,Iceland,0,0,0,0
1129,1980,GRE,Greece,4,1,0,5
1130,1980,GDR,Germany,73,131,99,47
1131,1980,GBR,UK,24,6,18,48
1132,1980,FRG,Germany,6,0,2,8
1133,1980,ECU,Ecuador,0,0,0,0
1134,1980,FRA,France,7,18,5,30
1135,1980,FIN,Finland,11,4,6,21
1136,1980,ETH,Ethiopia,2,2,0,4
1137,1980,GUA,Guatemala,0,0,0,0
1138,1980,ESP,Spain,3,2,19,24
1139,1984,NED,Netherlands,14,20,7,41
1140,1984,NEP,Nepal,0,0,0,0
1141,1984,NGR,Nigeria,4,0,1,5
1142,1984,NIG,Niger,0,0,0,0
1143,1984,NOR,Norway,7,6,6,19
1144,1984,NZL,New Zealand,6,16,1,23
1145,1984,PAR,Paraguay,0,0,0,0
1146,1984,PAK,Pakistan,0,16,0,16
1147,1984,PAN,Panama,0,0,0,0
1148,1984,PER,Peru,0,0,1,1
1149,1984,PHI,Philippines,0,0,0,0
1150,1984,PNG,Papua New Guinea,0,0,0,0
1151,1984,NCA,Nicaragua,0,0,0,0
1152,1984,POL,Poland,0,0,0,0
1153,1984,OMA,Oman,0,0,0,0
1154,1984,MYA,Myanmar,0,0,0,0
1155,1984,MAS,Malaysia,0,0,0,0
1156,1984,MRI,Mauritius,0,0,0,0
1157,1984,POR,Portugal,2,1,0,3
1158,1984,ZIM,Zimbabwe,0,0,0,0
1159,1984,LES,Lesotho,0,0,0,0
1160,1984,LIB,Lebanon,0,0,0,0
1161,1984,LIE,Liechtenstein,2,0,0,2
1162,1984,LUX,Luxembourg,0,0,0,0
1163,1984,MAD,Madagascar,0,0,0,0
1164,1984,MAR,Morocco,0,2,0,2
1165,1984,MAW,Malawi,0,0,0,0
1166,1984,MEX,Mexico,1,2,3,6
1167,1984,MGL,Mongolia,0,0,0,0
1168,1984,MLI,Mali,0,0,0,0
1169,1984,MLT,Malta,0,0,0,0
1170,1984,MON,Monaco,0,0,0,0
1171,1984,MOZ,Mozambique,0,0,0,0
1172,1984,MTN,Mauritania,0,0,0,0
1173,1984,PRK,North Korea,0,0,0,0
1174,1984,TOG,Togo,0,0,0,0
1175,1984,QAT,Qatar,0,0,0,0
1176,1984,THA,Thailand,0,0,1,1
1177,1984,TPE,Taiwan,1,0,0,1
1178,1984,TTO,Trinidad,0,0,0,0
1179,1984,TUN,Tunisia,0,0,0,0
1180,1984,TUR,Turkey,3,0,0,3
1181,1984,UAE,United Arab Emirates,0,0,0,0
1182,1984,UGA,Uganda,0,0,0,0
1183,1984,URS,Russia,12,29,15,56
1184,1984,URU,Uruguay,0,0,0,0
1185,1984,USA,USA,50,190,121,105
1186,1984,VEN,Venezuela,3,0,0,3
1187,1984,YAR,Yemen,0,0,0,0
1188,1984,YUG,Serbia,35,47,6,88
1189,1984,ZAM,Zambia,1,0,0,1
1190,1984,KUW,Kuwait,0,0,0,0
1191,1984,TGA,Tonga,0,0,0,0
1192,1984,PUR,Puerto Rico,1,0,1,2
1193,1984,TCH,Czech Republic,4,0,24,28
1194,1984,SYR,Syria,0,0,1,1
1195,1984,ROU,Romania,35,40,31,106
1196,1984,RWA,Rwanda,0,0,0,0
1197,1984,SAM,Samoa,0,0,0,0
1198,1984,SEN,Senegal,0,0,0,0
1199,1984,SEY,Seychelles,0,0,0,0
1200,1984,SLE,Sierra Leone,0,0,0,0
1201,1984,SMR,San Marino,0,0,0,0
1202,1984,SOL,Solomon Islands,0,0,0,0
1203,1984,SOM,Somalia,0,0,0,0
1204,1984,SRI,Sri Lanka,0,0,0,0
1205,1984,SUD,Sudan,0,0,0,0
1206,1984,SUI,Switzerland,8,2,11,21
1207,1984,SUR,Suriname,0,0,0,0
1208,1984,SWE,Sweden,34,10,20,64
1209,1984,SWZ,Swaziland,0,0,0,0
1210,1984,TAN,Tanzania,0,0,0,0
1211,1984,KSA,Saudi Arabia,0,0,0,0
1212,1984,LBR,Liberia,0,0,0,0
1213,1984,KEN,Kenya,2,1,0,3
1214,1984,BUL,Bulgaria,0,0,0,0
1215,1984,CAF,Central African Republic,0,0,0,0
1216,1984,CAN,Canada,33,21,37,91
1217,1984,CAY,Cayman Islands,0,0,0,0
1218,1984,CGO,Republic of Congo,0,0,0,0
1219,1984,CHA,Chad,0,0,0,0
1220,1984,BRN,Bahrain,0,0,0,0
1221,1984,CHI,Chile,0,0,0,0
1222,1984,CIV,Ivory Coast,0,0,1,1
1223,1984,CMR,Cameroon,1,0,0,1
1224,1984,COD,Democratic Republic of the Congo,0,0,0,0
1225,1984,COL,Colombia,0,0,1,1
1226,1984,CRC,Costa Rica,0,0,0,0
1227,1984,CYP,Cyprus,0,0,0,0
1228,1984,CHN,China,37,24,13,74
1229,1984,BRA,Brazil,2,1,33,36
1230,1984,BOL,Boliva,0,0,0,0
1231,1984,BIZ,Belize,0,0,0,0
1232,1984,KOR,South Korea,7,6,28,41
1233,1984,AHO,Curacao,0,0,0,0
1234,1984,ALG,Algeria,2,0,0,2
1235,1984,AND,Andorra,0,0,0,0
1236,1984,ANT,Antigua,0,0,0,0
1237,1984,ARG,Argentina,0,0,0,0
1238,1984,AUS,Australia,31,7,14,52
1239,1984,AUT,Austria,2,1,1,4
1240,1984,BAH,Bahamas,0,0,0,0
1241,1984,BAN,Bangladesh,0,0,0,0
1242,1984,BAR,Barbados,0,0,0,0
1243,1984,BEL,Belgium,2,1,2,5
1244,1984,BEN,Benin,0,0,0,0
1245,1984,BER,Bermuda,0,0,0,0
1246,1984,BHU,Bhutan,0,0,0,0
1247,1984,DEN,Denmark,10,0,3,13
1248,1984,DJI,Djibouti,0,0,0,0
1249,1984,BOT,Botswana,0,0,0,0
1250,1984,ECU,Ecuador,0,0,0,0
1251,1984,HKG,China,0,0,0,0
1252,1984,HON,Honduras,0,0,0,0
1253,1984,HUN,Hungary,0,0,0,0
1254,1984,INA,Indonesia,0,0,0,0
1255,1984,IND,India,0,0,0,0
1256,1984,IRQ,Iraq,0,0,0,0
1257,1984,ISL,Iceland,1,0,0,1
1258,1984,ISR,Israel,0,0,0,0
1259,1984,ISV,"Virgin Islands, US",0,0,0,0
1260,1984,ITA,Italy,28,31,6,65
1261,1984,IVB,"Virgin Islands, British",0,0,0,0
1262,1984,JAM,Jamaica,2,0,5,7
1263,1984,JOR,Jordan,0,0,0,0
1264,1984,DOM,Dominican Republic,1,0,0,1
1265,1984,JPN,Japan,31,10,9,50
1266,1984,HAI,Haiti,0,0,0,0
1267,1984,GUY,Guyana,0,0,0,0
1268,1984,IRL,Ireland,0,0,1,1
1269,1984,GUI,Guinea,0,0,0,0
1270,1984,EGY,Egypt,0,0,1,1
1271,1984,ESP,Spain,3,2,14,19
1272,1984,FIJ,Fiji,0,0,0,0
1273,1984,FIN,Finland,18,8,5,31
1274,1984,FRA,France,33,20,17,70
1275,1984,FRG,Germany,57,33,76,166
1276,1984,GAB,Gabon,0,0,0,0
1277,1984,GAM,Gambia,0,0,0,0
1278,1984,ESA,El Salvador,0,0,0,0
1279,1984,GDR,Germany,7,13,13,33
1280,1984,GEQ,Equatorial Guinea,0,0,0,0
1281,1984,GHA,Ghana,0,0,0,0
1282,1984,GRE,Greece,1,0,1,2
1283,1984,GRN,Grenada,0,0,0,0
1284,1984,GUA,Guatemala,0,0,0,0
1285,1984,GBR,UK,42,11,20,73
1286,1988,MRI,Mauritius,0,0,0,0
1287,1988,MTN,Mauritania,0,0,0,0
1288,1988,MYA,Myanmar,0,0,0,0
1289,1988,NED,Netherlands,38,6,8,52
1290,1988,NEP,Nepal,0,0,0,0
1291,1988,NGR,Nigeria,0,0,0,0
1292,1988,NIG,Niger,0,0,0,0
1293,1988,NOR,Norway,5,2,26,33
1294,1988,PAK,Pakistan,1,0,0,1
1295,1988,OMA,Oman,0,0,0,0
1296,1988,PAN,Panama,0,0,0,0
1297,1988,PAR,Paraguay,0,0,0,0
1298,1988,PER,Peru,0,0,12,12
1299,1988,PHI,Philippines,1,0,0,1
1300,1988,POL,Poland,10,2,9,21
1301,1988,PNG,Papua New Guinea,0,0,0,0
1302,1988,NZL,New Zealand,16,4,4,24
1303,1988,MOZ,Mozambique,0,0,0,0
1304,1988,KUW,Kuwait,0,0,0,0
1305,1988,MLT,Malta,0,0,0,0
1306,1988,POR,Portugal,0,1,0,1
1307,1988,KSA,Saudi Arabia,0,0,0,0
1308,1988,LAO,Laos,0,0,0,0
1309,1988,LBA,Libya,0,0,0,0
1310,1988,LBR,Liberia,0,0,0,0
1311,1988,LES,Lesotho,0,0,0,0
1312,1988,LIB,Lebanon,0,0,0,0
1313,1988,MON,Monaco,0,0,0,0
1314,1988,LIE,Liechtenstein,1,0,0,1
1315,1988,MAR,Morocco,2,1,0,3
1316,1988,MAS,Malaysia,0,0,0,0
1317,1988,MAW,Malawi,0,0,0,0
1318,1988,MDV,Maldives,0,0,0,0
1319,1988,MEX,Mexico,2,0,0,2
1320,1988,MGL,Mongolia,1,0,0,1
1321,1988,MLI,Mali,0,0,0,0
1322,1988,LUX,Luxembourg,0,0,0,0
1323,1988,PRK,North Korea,0,0,0,0
1324,1988,YMD,Yemen,0,0,0,0
1325,1988,QAT,Qatar,0,0,0,0
1326,1988,TTO,Trinidad,0,0,0,0
1327,1988,TUR,Turkey,0,1,1,2
1328,1988,UAE,United Arab Emirates,0,0,0,0
1329,1988,UGA,Uganda,0,0,0,0
1330,1988,URS,Russia,111,174,81,110
1331,1988,URU,Uruguay,0,0,0,0
1332,1988,USA,USA,58,89,67,214
1333,1988,TPE,Taiwan,0,0,0,0
1334,1988,VAN,Vanuatu,0,0,0,0
1335,1988,VIE,Vietnam,0,0,0,0
1336,1988,VIN,Saint Vincent,0,0,0,0
1337,1988,YAR,Yemen,0,0,0,0
1338,1988,KOR,South Korea,12,28,37,77
1339,1988,YUG,Serbia,22,15,32,69
1340,1988,ZAM,Zambia,0,0,0,0
1341,1988,ZIM,Zimbabwe,0,0,0,0
1342,1988,VEN,Venezuela,0,0,0,0
1343,1988,TOG,Togo,0,0,0,0
1344,1988,THA,Thailand,1,0,0,1
1345,1988,TGA,Tonga,0,0,0,0
1346,1988,ROU,Romania,16,8,34,58
1347,1988,RWA,Rwanda,0,0,0,0
1348,1988,SAM,Samoa,0,0,0,0
1349,1988,SEN,Senegal,0,0,1,1
1350,1988,SLE,Sierra Leone,0,0,0,0
1351,1988,SMR,San Marino,0,0,0,0
1352,1988,SOL,Solomon Islands,0,0,0,0
1353,1988,SOM,Somalia,0,0,0,0
1354,1988,SRI,Sri Lanka,0,0,0,0
1355,1988,SUD,Sudan,0,0,0,0
1356,1988,SUI,Switzerland,7,8,13,28
1357,1988,SUR,Suriname,0,1,0,1
1358,1988,SWE,Sweden,34,7,5,46
1359,1988,SWZ,Swaziland,0,0,0,0
1360,1988,SYR,Syria,0,0,0,0
1361,1988,TAN,Tanzania,0,0,0,0
1362,1988,TCH,Czech Republic,8,3,5,16
1363,1988,PUR,Puerto Rico,0,0,0,0
1364,1988,KEN,Kenya,2,5,2,9
1365,1988,TUN,Tunisia,0,0,0,0
1366,1988,JOR,Jordan,0,0,0,0
1367,1988,BOT,Botswana,0,0,0,0
1368,1988,BRA,Brazil,5,1,17,23
1369,1988,BRN,Bahrain,0,0,0,0
1370,1988,BUL,Bulgaria,17,10,14,41
1371,1988,BUR,Burkina Faso,0,0,0,0
1372,1988,CAF,Central African Republic,0,0,0,0
1373,1988,CAN,Canada,18,4,7,29
1374,1988,BOL,Boliva,0,0,0,0
1375,1988,CAY,Cayman Islands,0,0,0,0
1376,1988,CHA,Chad,0,0,0,0
1377,1988,CHI,Chile,0,0,1,1
1378,1988,CHN,China,30,6,16,52
1379,1988,CIV,Ivory Coast,0,0,0,0
1380,1988,CMR,Cameroon,0,0,0,0
1381,1988,COD,Democratic Republic of the Congo,0,0,0,0
1382,1988,COK,Cook Islands,0,0,0,0
1383,1988,CGO,Republic of Congo,0,0,0,0
1384,1988,COL,Colombia,1,0,0,1
1385,1988,BHU,Bhutan,0,0,0,0
1386,1988,BEN,Benin,0,0,0,0
1387,1988,JPN,Japan,14,4,3,21
1388,1988,AFG,Afghanistan,0,0,0,0
1389,1988,AHO,Curacao,0,0,1,1
1390,1988,ALG,Algeria,0,0,0,0
1391,1988,AND,Andorra,0,0,0,0
1392,1988,ANG,Angola,0,0,0,0
1393,1988,ANT,Antigua,0,0,0,0
1394,1988,BER,Bermuda,0,0,0,0
1395,1988,ARG,Argentina,12,0,1,13
1396,1988,ASA,American Samoa,0,0,0,0
1397,1988,AUS,Australia,11,18,6,35
1398,1988,AUT,Austria,4,4,5,13
1399,1988,BAH,Bahamas,0,0,0,0
1400,1988,BAN,Bangladesh,0,0,0,0
1401,1988,BAR,Barbados,0,0,0,0
1402,1988,BEL,Belgium,2,0,0,2
1403,1988,ARU,Aruba,0,0,0,0
1404,1988,CRC,Costa Rica,0,0,1,1
1405,1988,BIZ,Belize,0,0,0,0
1406,1988,DEN,Denmark,3,3,1,7
1407,1988,GUM,Guam,0,0,0,0
1408,1988,GUY,Guyana,0,0,0,0
1409,1988,HAI,Haiti,0,0,0,0
1410,1988,HKG,China,0,0,0,0
1411,1988,HON,Honduras,0,0,0,0
1412,1988,HUN,Hungary,15,20,9,44
1413,1988,IND,India,0,0,0,0
1414,1988,GUI,Guinea,0,0,0,0
1415,1988,IRI,Iran,0,0,1,1
1416,1988,IRQ,Iraq,0,0,0,0
1417,1988,ISL,Iceland,0,0,0,0
1418,1988,ISR,Israel,0,0,0,0
1419,1988,ISV,"Virgin Islands, US",0,0,1,1
1420,1988,ITA,Italy,13,13,11,37
1421,1988,IVB,"Virgin Islands, British",0,0,0,0
1422,1988,CYP,Cyprus,0,0,0,0
1423,1988,IRL,Ireland,0,0,0,0
1424,1988,GUA,Guatemala,0,0,0,0
1425,1988,INA,Indonesia,0,0,3,3
1426,1988,GRN,Grenada,0,0,0,0
1427,1988,DJI,Djibouti,1,0,0,1
1428,1988,DOM,Dominican Republic,0,0,0,0
1429,1988,ECU,Ecuador,0,0,0,0
1430,1988,EGY,Egypt,0,0,0,0
1431,1988,ESA,El Salvador,0,0,0,0
1432,1988,ESP,Spain,2,1,2,5
1433,1988,FIJ,Fiji,0,0,0,0
1434,1988,FIN,Finland,7,8,23,38
1435,1988,FRA,France,14,13,4,31
1436,1988,JAM,Jamaica,0,0,7,7
1437,1988,GAB,Gabon,0,0,0,0
1438,1988,GAM,Gambia,0,0,0,0
1439,1988,GBR,UK,15,22,17,54
1440,1988,GDR,Germany,55,89,69,213
1441,1988,GEQ,Equatorial Guinea,0,0,0,0
1442,1988,GHA,Ghana,0,0,0,0
1443,1988,GRE,Greece,1,0,0,1
1444,1988,FRG,Germany,49,36,44,129
1445,1992,MOZ,Mozambique,0,0,0,0
1446,1992,MRI,Mauritius,0,0,0,0
1447,1992,MTN,Mauritania,0,0,0,0
1448,1992,MYA,Myanmar,0,0,0,0
1449,1992,NAM,Namibia,0,0,2,2
1450,1992,NCA,Nicaragua,0,0,0,0
1451,1992,NED,Netherlands,10,6,21,37
1452,1992,NEP,Nepal,0,0,0,0
1453,1992,OMA,Oman,0,0,0,0
1454,1992,NIG,Niger,0,0,0,0
1455,1992,NOR,Norway,6,11,30,47
1456,1992,NZL,New Zealand,5,1,10,16
1457,1992,PAK,Pakistan,16,0,0,16
1458,1992,PAN,Panama,0,0,0,0
1459,1992,PAR,Paraguay,0,0,0,0
1460,1992,PHI,Philippines,1,0,0,1
1461,1992,NGR,Nigeria,4,0,7,11
1462,1992,PER,Peru,0,0,1,1
1463,1992,KUW,Kuwait,0,0,0,0
1464,1992,MLT,Malta,0,0,0,0
1465,1992,PNG,Papua New Guinea,0,0,0,0
1466,1992,KSA,Saudi Arabia,0,0,0,0
1467,1992,LAO,Laos,0,0,0,0
1468,1992,LAT,Latvia,1,0,2,3
1469,1992,LBA,Libya,0,0,0,0
1470,1992,LES,Lesotho,0,0,0,0
1471,1992,LIB,Lebanon,0,0,0,0
1472,1992,LIE,Liechtenstein,0,0,0,0
1473,1992,MON,Monaco,0,0,0,0
1474,1992,LTU,Lithuania,12,1,0,13
1475,1992,MAD,Madagascar,0,0,0,0
1476,1992,MAR,Morocco,1,1,1,3
1477,1992,MAS,Malaysia,2,0,0,2
1478,1992,MAW,Malawi,0,0,0,0
1479,1992,MDV,Maldives,0,0,0,0
1480,1992,MEX,Mexico,0,0,1,1
1481,1992,MGL,Mongolia,2,0,0,2
1482,1992,MLI,Mali,0,0,0,0
1483,1992,LUX,Luxembourg,0,0,2,2
1484,1992,POL,Poland,19,5,22,46
1485,1992,YEM,Yemen,0,0,0,0
1486,1992,PRK,North Korea,7,4,0,11
1487,1992,THA,Thailand,1,0,0,1
1488,1992,TOG,Togo,0,0,0,0
1489,1992,TPE,Taiwan,0,0,20,20
1490,1992,TTO,Trinidad,0,0,0,0
1491,1992,TUN,Tunisia,0,0,0,0
1492,1992,TUR,Turkey,2,2,2,6
1493,1992,UAE,United Arab Emirates,0,0,0,0
1494,1992,UGA,Uganda,0,0,0,0
1495,1992,TGA,Tonga,0,0,0,0
1496,1992,URU,Uruguay,0,0,0,0
1497,1992,VAN,Vanuatu,0,0,0,0
1498,1992,VEN,Venezuela,0,0,0,0
1499,1992,VIE,Vietnam,0,0,0,0
1500,1992,VIN,Saint Vincent,0,0,0,0
1501,1992,KOR,South Korea,17,33,6,56
1502,1992,YUG,Serbia,0,0,0,0
1503,1992,ZAM,Zambia,0,0,0,0
1504,1992,ZIM,Zimbabwe,0,0,0,0
1505,1992,USA,USA,87,94,57,238
1506,1992,POR,Portugal,0,0,0,0
1507,1992,TCH,Czech Republic,28,4,3,35
1508,1992,SYR,Syria,0,0,0,0
1509,1992,PUR,Puerto Rico,1,0,0,1
1510,1992,QAT,Qatar,1,0,0,1
1511,1992,ROU,Romania,14,8,31,53
1512,1992,RSA,South Africa,0,0,3,3
1513,1992,RWA,Rwanda,0,0,0,0
1514,1992,SAM,Samoa,0,0,0,0
1515,1992,SEN,Senegal,0,0,0,0
1516,1992,SEY,Seychelles,0,0,0,0
1517,1992,TAN,Tanzania,0,0,0,0
1518,1992,SLE,Sierra Leone,0,0,0,0
1519,1992,SMR,San Marino,0,0,0,0
1520,1992,SOL,Solomon Islands,0,0,0,0
1521,1992,SRI,Sri Lanka,0,0,0,0
1522,1992,SUD,Sudan,0,0,0,0
1523,1992,SUI,Switzerland,5,3,0,8
1524,1992,SUR,Suriname,1,0,0,1
1525,1992,SWE,Sweden,13,2,27,42
1526,1992,SWZ,Swaziland,0,0,0,0
1527,1992,SLO,Slovenia,6,0,0,6
1528,1992,KEN,Kenya,2,2,4,8
1529,1992,GRE,Greece,0,2,0,2
1530,1992,JOR,Jordan,0,0,0,0
1531,1992,BRA,Brazil,0,13,1,14
1532,1992,BRN,Bahrain,0,0,0,0
1533,1992,JPN,Japan,43,6,10,59
1534,1992,BUR,Burkina Faso,0,0,0,0
1535,1992,CAF,Central African Republic,0,0,0,0
1536,1992,CAN,Canada,15,32,33,80
1537,1992,CAY,Cayman Islands,0,0,0,0
1538,1992,CGO,Republic of Congo,0,0,0,0
1539,1992,CHA,Chad,0,0,0,0
1540,1992,CHI,Chile,0,0,0,0
1541,1992,CHN,China,19,18,48,85
1542,1992,CIV,Ivory Coast,0,0,0,0
1543,1992,CMR,Cameroon,0,0,0,0
1544,1992,COD,Democratic Republic of the Congo,0,0,0,0
1545,1992,COK,Cook Islands,0,0,0,0
1546,1992,COL,Colombia,1,0,0,1
1547,1992,CRC,Costa Rica,0,0,0,0
1548,1992,BOT,Botswana,0,0,0,0
1549,1992,BOL,Boliva,0,0,0,0
1550,1992,BIZ,Belize,0,0,0,0
1551,1992,BIH,Bosnia and Herzegovina,0,0,0,0
1552,1992,AHO,Curacao,0,0,0,0
1553,1992,ALB,Albania,0,0,0,0
1554,1992,ALG,Algeria,1,1,0,2
1555,1992,AND,Andorra,0,0,0,0
1556,1992,ANG,Angola,0,0,0,0
1557,1992,ANT,Antigua,0,0,0,0
1558,1992,ARG,Argentina,2,0,0,2
1559,1992,ARU,Aruba,0,0,0,0
1560,1992,CRO,Croatia,3,0,12,15
1561,1992,ASA,American Samoa,0,0,0,0
1562,1992,AUT,Austria,10,9,16,35
1563,1992,BAH,Bahamas,1,0,0,1
1564,1992,BAN,Bangladesh,0,0,0,0
1565,1992,BAR,Barbados,0,0,0,0
1566,1992,BEL,Belgium,2,0,1,3
1567,1992,BEN,Benin,0,0,0,0
1568,1992,BER,Bermuda,0,0,0,0
1569,1992,BHU,Bhutan,0,0,0,0
1570,1992,AUS,Australia,16,14,27,57
1571,1992,CUB,Cuba,14,42,13,69
1572,1992,BUL,Bulgaria,7,3,7,17
1573,1992,DEN,Denmark,9,3,2,14
1574,1992,GUY,Guyana,0,0,0,0
1575,1992,HAI,Haiti,0,0,0,0
1576,1992,HKG,China,0,0,0,0
1577,1992,HON,Honduras,0,0,0,0
1578,1992,HUN,Hungary,8,14,23,45
1579,1992,INA,Indonesia,1,2,3,6
1580,1992,IND,India,0,0,0,0
1581,1992,IOA,Individual Olympic Athletes,2,0,1,3
1582,1992,IRI,Iran,2,0,1,3
1583,1992,IRL,Ireland,0,1,1,2
1584,1992,IRQ,Iraq,0,0,0,0
1585,1992,ISL,Iceland,0,0,0,0
1586,1992,ISR,Israel,1,0,1,2
1587,1992,CYP,Cyprus,0,0,0,0
1588,1992,ITA,Italy,22,25,19,66
1589,1992,IVB,"Virgin Islands, British",0,0,0,0
1590,1992,JAM,Jamaica,1,0,3,4
1591,1992,GUM,Guam,0,0,0,0
1592,1992,GUI,Guinea,0,0,0,0
1593,1992,ISV,"Virgin Islands, US",0,0,0,0
1594,1992,GRN,Grenada,0,0,0,0
1595,1992,GUA,Guatemala,0,0,0,0
1596,1992,DJI,Djibouti,0,0,0,0
1597,1992,ECU,Ecuador,0,0,0,0
1598,1992,EGY,Egypt,0,0,0,0
1599,1992,ESA,El Salvador,0,0,0,0
1600,1992,ESP,Spain,3,48,19,70
1601,1992,EST,Estonia,2,1,0,3
1602,1992,ETH,Ethiopia,2,1,0,3
1603,1992,EUN,Russia,81,127,71,23
1604,1992,DOM,Dominican Republic,0,0,0,0
1605,1992,FIN,Finland,8,7,5,20
1606,1992,FRA,France,44,14,11,69
1607,1992,GAB,Gabon,0,0,0,0
1608,1992,GAM,Gambia,0,0,0,0
1609,1992,GBR,UK,39,8,3,50
1610,1992,GEQ,Equatorial Guinea,0,0,0,0
1611,1992,GER,Germany,67,95,74,236
1612,1992,FIJ,Fiji,0,0,0,0
1613,1992,GHA,Ghana,20,0,0,20
1614,1994,NZL,New Zealand,0,0,0,0
1615,1994,NOR,Norway,5,8,17,30
1616,1994,NED,Netherlands,3,0,1,4
1617,1994,MON,Monaco,0,0,0,0
1618,1994,MGL,Mongolia,0,0,0,0
1619,1994,MEX,Mexico,0,0,0,0
1620,1994,LIE,Liechtenstein,0,0,0,0
1621,1994,LUX,Luxembourg,0,0,0,0
1622,1994,LTU,Lithuania,0,0,0,0
1623,1994,LAT,Latvia,0,0,0,0
1624,1994,KOR,South Korea,1,7,1,9
1625,1994,KGZ,Kyrgyzstan,0,0,0,0
1626,1994,POL,Poland,0,0,0,0
1627,1994,MDA,Moldova,0,0,0,0
1628,1994,POR,Portugal,0,0,0,0
1629,1994,SWE,Sweden,0,23,1,24
1630,1994,ROU,Romania,0,0,0,0
1631,1994,KAZ,Kazakhstan,0,1,2,3
1632,1994,UZB,Uzbekistan,0,1,0,1
1633,1994,USA,USA,5,6,8,19
1634,1994,UKR,Ukraine,1,1,0,2
1635,1994,TUR,Turkey,0,0,0,0
1636,1994,TTO,Trinidad,0,0,0,0
1637,1994,PUR,Puerto Rico,0,0,0,0
1638,1994,TPE,Taiwan,0,0,0,0
1639,1994,SUI,Switzerland,4,4,8,16
1640,1994,SMR,San Marino,0,0,0,0
1641,1994,SLO,Slovenia,3,0,0,3
1642,1994,SEN,Senegal,0,0,0,0
1643,1994,RUS,Russia,4,19,13,36
1644,1994,RSA,South Africa,0,0,0,0
1645,1994,SVK,Slovakia,0,0,0,0
1646,1994,JPN,Japan,2,3,5,10
1647,1994,GRE,Greece,0,0,0,0
1648,1994,ITA,Italy,12,14,6,32
1649,1994,AND,Andorra,0,0,0,0
1650,1994,ARG,Argentina,0,0,0,0
1651,1994,ARM,Armenia,0,0,0,0
1652,1994,ASA,American Samoa,0,0,0,0
1653,1994,AUS,Australia,4,0,0,4
1654,1994,BEL,Belgium,0,0,0,0
1655,1994,BER,Bermuda,0,0,0,0
1656,1994,BIH,Bosnia and Herzegovina,0,0,0,0
1657,1994,BLR,Belarus,0,0,2,2
1658,1994,BRA,Brazil,0,0,0,0
1659,1994,BUL,Bulgaria,0,0,0,0
1660,1994,CAN,Canada,5,3,29,37
1661,1994,CHI,Chile,0,0,0,0
1662,1994,CHN,China,2,0,1,3
1663,1994,CRO,Croatia,0,0,0,0
1664,1994,AUT,Austria,7,2,3,12
1665,1994,CZE,Czech Republic,0,0,0,0
1666,1994,CYP,Cyprus,0,0,0,0
1667,1994,ISV,"Virgin Islands, US",0,0,0,0
1668,1994,ISR,Israel,0,0,0,0
1669,1994,ISL,Iceland,0,0,0,0
1670,1994,JAM,Jamaica,0,0,0,0
1671,1994,GER,Germany,12,18,10,40
1672,1994,GEO,Georgia,0,0,0,0
1673,1994,HUN,Hungary,0,0,0,0
1674,1994,FRA,France,10,0,1,11
1675,1994,FIN,Finland,29,0,1,30
1676,1994,FIJ,Fiji,0,0,0,0
1677,1994,EST,Estonia,0,0,0,0
1678,1994,ESP,Spain,0,0,0,0
1679,1994,GBR,UK,3,0,0,3
1680,1994,DEN,Denmark,0,0,0,0
1681,1996,NGR,Nigeria,3,17,4,24
1682,1996,NEP,Nepal,0,0,0,0
1683,1996,NED,Netherlands,26,38,9,73
1684,1996,NCA,Nicaragua,0,0,0,0
1685,1996,MYA,Myanmar,0,0,0,0
1686,1996,MTN,Mauritania,0,0,0,0
1687,1996,NIG,Niger,0,0,0,0
1688,1996,MRI,Mauritius,0,0,0,0
1689,1996,NAM,Namibia,0,0,2,2
1690,1996,NOR,Norway,18,2,3,23
1691,1996,PHI,Philippines,0,0,1,1
1692,1996,NZL,New Zealand,4,3,2,9
1693,1996,OMA,Oman,0,0,0,0
1694,1996,PAK,Pakistan,0,0,0,0
1695,1996,PAN,Panama,0,0,0,0
1696,1996,PAR,Paraguay,0,0,0,0
1697,1996,PER,Peru,0,0,0,0
1698,1996,PLE,Palestine,0,0,0,0
1699,1996,PNG,Papua New Guinea,0,0,0,0
1700,1996,MOZ,Mozambique,1,0,0,1
1701,1996,NRU,Nauru,0,0,0,0
1702,1996,MON,Monaco,0,0,0,0
1703,1996,LCA,Saint Lucia,0,0,0,0
1704,1996,MLI,Mali,0,0,0,0
1705,1996,KSA,Saudi Arabia,0,0,0,0
1706,1996,KUW,Kuwait,0,0,0,0
1707,1996,LAO,Laos,0,0,0,0
1708,1996,LAT,Latvia,0,0,1,1
1709,1996,LBA,Libya,0,0,0,0
1710,1996,LBR,Liberia,0,0,0,0
1711,1996,POL,Poland,7,7,8,22
1712,1996,LES,Lesotho,0,0,0,0
1713,1996,LIB,Lebanon,0,0,0,0
1714,1996,LIE,Liechtenstein,0,0,0,0
1715,1996,LTU,Lithuania,11,0,0,11
1716,1996,LUX,Luxembourg,0,0,0,0
1717,1996,MAD,Madagascar,0,0,0,0
1718,1996,MAR,Morocco,2,0,0,2
1719,1996,MAS,Malaysia,1,0,2,3
1720,1996,MAW,Malawi,0,0,0,0
1721,1996,MDA,Moldova,1,0,2,3
1722,1996,MDV,Maldives,0,0,0,0
1723,1996,MEX,Mexico,1,0,0,1
1724,1996,MGL,Mongolia,1,0,0,1
1725,1996,MKD,Macedonia,0,0,0,0
1726,1996,MLT,Malta,0,0,0,0
1727,1996,POR,Portugal,2,1,0,3
1728,1996,SOM,Somalia,0,0,0,0
1729,1996,PUR,Puerto Rico,1,0,0,1
1730,1996,THA,Thailand,1,1,0,2
1731,1996,TJK,Tajikistan,0,0,0,0
1732,1996,TKM,Turkmenistan,0,0,0,0
1733,1996,TOG,Togo,0,0,0,0
1734,1996,TPE,Taiwan,0,0,1,1
1735,1996,TTO,Trinidad,2,0,0,2
1736,1996,TUN,Tunisia,1,0,0,1
1737,1996,TUR,Turkey,1,4,1,6
1738,1996,UAE,United Arab Emirates,0,0,0,0
1739,1996,UGA,Uganda,1,0,0,1
1740,1996,UKR,Ukraine,19,10,5,34
1741,1996,URU,Uruguay,0,0,0,0
1742,1996,USA,USA,52,159,48,3
1743,1996,UZB,Uzbekistan,1,0,1,2
1744,1996,VAN,Vanuatu,0,0,0,0
1745,1996,VEN,Venezuela,0,0,0,0
1746,1996,VIE,Vietnam,0,0,0,0
1747,1996,VIN,Saint Vincent,0,0,0,0
1748,1996,YEM,Yemen,0,0,0,0
1749,1996,ZAM,Zambia,0,0,1,1
1750,1996,ZIM,Zimbabwe,0,0,0,0
1751,1996,TGA,Tonga,0,0,1,1
1752,1996,PRK,North Korea,2,2,1,5
1753,1996,TAN,Tanzania,0,0,0,0
1754,1996,SWZ,Swaziland,0,0,0,0
1755,1996,QAT,Qatar,0,0,0,0
1756,1996,ROU,Romania,15,13,10,38
1757,1996,RSA,South Africa,1,3,1,5
1758,1996,RUS,Russia,34,36,45,115
1759,1996,RWA,Rwanda,0,0,0,0
1760,1996,SAM,Samoa,0,0,0,0
1761,1996,SCG,Serbia,13,1,12,26
1762,1996,SEN,Senegal,0,0,0,0
1763,1996,SEY,Seychelles,0,0,0,0
1764,1996,SKN,Saint Kitts,0,0,0,0
1765,1996,SLE,Sierra Leone,0,0,0,0
1766,1996,SLO,Slovenia,0,0,2,2
1767,1996,SMR,San Marino,0,0,0,0
1768,1996,SOL,Solomon Islands,0,0,0,0
1769,1996,KOR,South Korea,7,10,49,66
1770,1996,SRI,Sri Lanka,0,0,0,0
1771,1996,STP,Sao Tome and Principe,0,0,0,0
1772,1996,SUI,Switzerland,0,5,6,11
1773,1996,SUR,Suriname,0,0,0,0
1774,1996,SVK,Slovakia,1,1,1,3
1775,1996,SWE,Sweden,5,3,23,31
1776,1996,SYR,Syria,0,1,0,1
1777,1996,KGZ,Kyrgyzstan,0,0,0,0
1778,1996,SUD,Sudan,0,0,0,0
1779,1996,KAZ,Kazakhstan,4,3,4,11
1780,1996,BOL,Boliva,0,0,0,0
1781,1996,BOT,Botswana,0,0,0,0
1782,1996,BRA,Brazil,43,5,15,63
1783,1996,BRN,Bahrain,0,0,0,0
1784,1996,BRU,Brunei,0,0,0,0
1785,1996,BUR,Burkina Faso,0,0,0,0
1786,1996,CAF,Central African Republic,0,0,0,0
1787,1996,CAM,Cambodia,0,0,0,0
1788,1996,CAN,Canada,12,8,30,50
1789,1996,BLR,Belarus,16,1,6,23
1790,1996,CAY,Cayman Islands,0,0,0,0
1791,1996,CHA,Chad,0,0,0,0
1792,1996,CHI,Chile,0,0,0,0
1793,1996,CHN,China,17,19,70,106
1794,1996,CIV,Ivory Coast,0,0,0,0
1795,1996,CMR,Cameroon,0,0,0,0
1796,1996,COD,Democratic Republic of the Congo,0,0,0,0
1797,1996,COK,Cook Islands,0,0,0,0
1798,1996,COL,Colombia,0,0,0,0
1799,1996,COM,Comoros,0,0,0,0
1800,1996,CGO,Republic of Congo,0,0,0,0
1801,1996,BIZ,Belize,0,0,0,0
1802,1996,BIH,Bosnia and Herzegovina,0,0,0,0
1803,1996,BHU,Bhutan,0,0,0,0
1804,1996,AFG,Afghanistan,0,0,0,0
1805,1996,AHO,Curacao,0,0,0,0
1806,1996,ALB,Albania,0,0,0,0
1807,1996,ALG,Algeria,1,2,0,3
1808,1996,AND,Andorra,0,0,0,0
1809,1996,ANG,Angola,0,0,0,0
1810,1996,ANT,Antigua,0,0,0,0
1811,1996,ARG,Argentina,1,0,19,20
1812,1996,ARM,Armenia,0,1,1,2
1813,1996,ARU,Aruba,0,0,0,0
1814,1996,ASA,American Samoa,0,0,0,0
1815,1996,AUS,Australia,84,32,16,132
1816,1996,AUT,Austria,2,0,1,3
1817,1996,AZE,Azerbaijan,0,0,1,1
1818,1996,BAH,Bahamas,0,0,5,5
1819,1996,BAN,Bangladesh,0,0,0,0
1820,1996,BAR,Barbados,0,0,0,0
1821,1996,BDI,Burundi,0,1,0,1
1822,1996,BEL,Belgium,2,2,2,6
1823,1996,BEN,Benin,0,0,0,0
1824,1996,BER,Bermuda,0,0,0,0
1825,1996,CPV,Cape Verde,0,0,0,0
1826,1996,CRC,Costa Rica,0,1,0,1
1827,1996,BUL,Bulgaria,6,3,12,21
1828,1996,CUB,Cuba,10,37,8,55
1829,1996,GRN,Grenada,0,0,0,0
1830,1996,GUA,Guatemala,0,0,0,0
1831,1996,GUI,Guinea,0,0,0,0
1832,1996,GUM,Guam,0,0,0,0
1833,1996,GUY,Guyana,0,0,0,0
1834,1996,HAI,Haiti,0,0,0,0
1835,1996,HKG,China,0,1,0,1
1836,1996,HON,Honduras,0,0,0,0
1837,1996,HUN,Hungary,26,8,9,43
1838,1996,INA,Indonesia,3,2,1,6
1839,1996,GRE,Greece,0,4,4,8
1840,1996,IND,India,1,0,0,1
1841,1996,IRL,Ireland,1,3,0,4
1842,1996,IRQ,Iraq,0,0,0,0
1843,1996,CRO,Croatia,0,16,12,28
1844,1996,ISR,Israel,1,0,0,1
1845,1996,ISV,"Virgin Islands, US",0,0,0,0
1846,1996,ITA,Italy,28,19,24,71
1847,1996,IVB,"Virgin Islands, British",0,0,0,0
1848,1996,JAM,Jamaica,12,1,3,16
1849,1996,JOR,Jordan,0,0,0,0
1850,1996,JPN,Japan,13,3,26,42
1851,1996,IRI,Iran,1,1,1,3
1852,1996,GHA,Ghana,0,0,0,0
1853,1996,ISL,Iceland,0,0,0,0
1854,1996,GEQ,Equatorial Guinea,0,0,0,0
1855,1996,GER,Germany,47,42,35,124
1856,1996,CYP,Cyprus,0,0,0,0
1857,1996,CZE,Czech Republic,4,4,5,13
1858,1996,DEN,Denmark,1,21,1,23
1859,1996,DJI,Djibouti,0,0,0,0
1860,1996,DMA,Dominica,0,0,0,0
1861,1996,DOM,Dominican Republic,0,0,0,0
1862,1996,ECU,Ecuador,0,1,0,1
1863,1996,EGY,Egypt,0,0,0,0
1864,1996,ESA,El Salvador,0,0,0,0
1865,1996,ESP,Spain,22,23,21,66
1866,1996,KEN,Kenya,3,1,4,8
1867,1996,ETH,Ethiopia,1,2,0,3
1868,1996,FIJ,Fiji,0,0,0,0
1869,1996,FIN,Finland,1,1,2,4
1870,1996,FRA,France,20,21,10,51
1871,1996,GAB,Gabon,0,0,0,0
1872,1996,GAM,Gambia,0,0,0,0
1873,1996,EST,Estonia,0,0,0,0
1874,1996,GBR,UK,9,2,15,26
1875,1996,GBS,Guinea-Bissau,0,0,0,0
1876,1996,GEO,Georgia,2,0,0,2
1877,1998,NZL,New Zealand,0,0,0,0
1878,1998,NOR,Norway,12,13,15,40
1879,1998,NED,Netherlands,2,5,4,11
1880,1998,MON,Monaco,0,0,0,0
1881,1998,MKD,Macedonia,0,0,0,0
1882,1998,MGL,Mongolia,0,0,0,0
1883,1998,LIE,Liechtenstein,0,0,0,0
1884,1998,LUX,Luxembourg,0,0,0,0
1885,1998,LTU,Lithuania,0,0,0,0
1886,1998,POL,Poland,0,0,0,0
1887,1998,LAT,Latvia,0,0,0,0
1888,1998,KOR,South Korea,2,6,4,12
1889,1998,KGZ,Kyrgyzstan,0,0,0,0
1890,1998,KEN,Kenya,0,0,0,0
1891,1998,MDA,Moldova,0,0,0,0
1892,1998,POR,Portugal,0,0,0,0
1893,1998,RUS,Russia,6,14,32,52
1894,1998,PUR,Puerto Rico,0,0,0,0
1895,1998,KAZ,Kazakhstan,2,0,0,2
1896,1998,VEN,Venezuela,0,0,0,0
1897,1998,UZB,Uzbekistan,0,0,0,0
1898,1998,USA,USA,5,25,4,34
1899,1998,URU,Uruguay,0,0,0,0
1900,1998,UKR,Ukraine,0,0,1,1
1901,1998,TUR,Turkey,0,0,0,0
1902,1998,TPE,Taiwan,0,0,0,0
1903,1998,SWE,Sweden,5,0,2,7
1904,1998,SVK,Slovakia,0,0,0,0
1905,1998,SUI,Switzerland,3,6,5,14
1906,1998,SLO,Slovenia,0,0,0,0
1907,1998,SCG,Serbia,0,0,0,0
1908,1998,RSA,South Africa,0,0,0,0
1909,1998,ROU,Romania,0,0,0,0
1910,1998,PRK,North Korea,0,0,0,0
1911,1998,TTO,Trinidad,0,0,0,0
1912,1998,JPN,Japan,4,8,1,13
1913,1998,ITA,Italy,5,3,9,17
1914,1998,CHN,China,5,0,9,14
1915,1998,CHI,Chile,0,0,0,0
1916,1998,CAN,Canada,7,14,28,49
1917,1998,BUL,Bulgaria,0,1,0,1
1918,1998,BRA,Brazil,0,0,0,0
1919,1998,BLR,Belarus,2,0,0,2
1920,1998,BIH,Bosnia and Herzegovina,0,0,0,0
1921,1998,BER,Bermuda,0,0,0,0
1922,1998,AZE,Azerbaijan,0,0,0,0
1923,1998,AUT,Austria,12,3,5,20
1924,1998,AUS,Australia,1,0,0,1
1925,1998,ARM,Armenia,0,0,0,0
1926,1998,ARG,Argentina,0,0,0,0
1927,1998,AND,Andorra,0,0,0,0
1928,1998,JAM,Jamaica,0,0,0,0
1929,1998,CRO,Croatia,0,0,0,0
1930,1998,CYP,Cyprus,0,0,0,0
1931,1998,BEL,Belgium,1,0,0,1
1932,1998,DEN,Denmark,0,0,5,5
1933,1998,ISV,"Virgin Islands, US",0,0,0,0
1934,1998,CZE,Czech Republic,1,21,1,23
1935,1998,ISR,Israel,0,0,0,0
1936,1998,ISL,Iceland,0,0,0,0
1937,1998,IRL,Ireland,0,0,0,0
1938,1998,IND,India,0,0,0,0
1939,1998,HUN,Hungary,0,0,0,0
1940,1998,IRI,Iran,0,0,0,0
1941,1998,GER,Germany,10,22,12,44
1942,1998,GEO,Georgia,0,0,0,0
1943,1998,GBR,UK,4,0,0,4
1944,1998,FRA,France,12,2,1,15
1945,1998,FIN,Finland,49,2,7,58
1946,1998,ESP,Spain,0,0,0,0
1947,1998,GRE,Greece,0,0,0,0
1948,1998,EST,Estonia,0,0,0,0
1949,2000,MRI,Mauritius,0,0,0,0
1950,2000,NEP,Nepal,0,0,0,0
1951,2000,NED,Netherlands,23,27,29,79
1952,2000,MYA,Myanmar,0,0,0,0
1953,2000,NAM,Namibia,0,0,0,0
1954,2000,MTN,Mauritania,0,0,0,0
1955,2000,NGR,Nigeria,0,6,2,8
1956,2000,NCA,Nicaragua,0,0,0,0
1957,2000,NIG,Niger,0,0,0,0
1958,2000,PER,Peru,0,0,0,0
1959,2000,NRU,Nauru,0,0,0,0
1960,2000,NZL,New Zealand,3,1,0,4
1961,2000,OMA,Oman,0,0,0,0
1962,2000,PAK,Pakistan,0,0,0,0
1963,2000,PAN,Panama,0,0,0,0
1964,2000,PAR,Paraguay,0,0,0,0
1965,2000,PHI,Philippines,0,0,0,0
1966,2000,PLE,Palestine,0,0,0,0
1967,2000,PLW,Palau,0,0,0,0
1968,2000,MOZ,Mozambique,0,1,0,1
1969,2000,NOR,Norway,19,20,4,43
1970,2000,MON,Monaco,0,0,0,0
1971,2000,LBR,Liberia,0,0,0,0
1972,2000,MLI,Mali,0,0,0,0
1973,2000,KOR,South Korea,35,12,26,73
1974,2000,KSA,Saudi Arabia,1,0,1,2
1975,2000,KUW,Kuwait,1,0,0,1
1976,2000,LAO,Laos,0,0,0,0
1977,2000,LAT,Latvia,1,1,1,3
1978,2000,ZIM,Zimbabwe,0,0,0,0
1979,2000,PNG,Papua New Guinea,0,0,0,0
1980,2000,LCA,Saint Lucia,0,0,0,0
1981,2000,LES,Lesotho,0,0,0,0
1982,2000,LIB,Lebanon,0,0,0,0
1983,2000,MLT,Malta,0,0,0,0
1984,2000,LIE,Liechtenstein,0,0,0,0
1985,2000,LUX,Luxembourg,0,0,0,0
1986,2000,MAD,Madagascar,0,0,0,0
1987,2000,MAR,Morocco,4,0,1,5
1988,2000,MAS,Malaysia,0,0,0,0
1989,2000,MAW,Malawi,0,0,0,0
1990,2000,MDA,Moldova,1,0,1,2
1991,2000,MDV,Maldives,0,0,0,0
1992,2000,MEX,Mexico,3,1,2,6
1993,2000,MGL,Mongolia,0,0,0,0
1994,2000,MKD,Macedonia,1,0,0,1
1995,2000,LTU,Lithuania,15,2,0,17
1996,2000,POL,Poland,7,7,10,24
1997,2000,SOM,Somalia,0,0,0,0
1998,2000,PRK,North Korea,3,0,1,4
1999,2000,THA,Thailand,2,1,0,3
2000,2000,TJK,Tajikistan,0,0,0,0
2001,2000,TKM,Turkmenistan,0,0,0,0
2002,2000,TOG,Togo,0,0,0,0
2003,2000,TPE,Taiwan,4,0,1,5
2004,2000,TTO,Trinidad,1,0,1,2
2005,2000,TUN,Tunisia,0,0,0,0
2006,2000,TUR,Turkey,2,3,0,5
2007,2000,UAE,United Arab Emirates,0,0,0,0
2008,2000,UGA,Uganda,0,0,0,0
2009,2000,UKR,Ukraine,12,3,20,35
2010,2000,URU,Uruguay,0,0,1,1
2011,2000,USA,USA,51,130,61,242
2012,2000,UZB,Uzbekistan,2,1,1,4
2013,2000,VAN,Vanuatu,0,0,0,0
2014,2000,VEN,Venezuela,0,0,0,0
2015,2000,VIE,Vietnam,0,0,1,1
2016,2000,VIN,Saint Vincent,0,0,0,0
2017,2000,YEM,Yemen,0,0,0,0
2018,2000,ZAM,Zambia,0,0,0,0
2019,2000,KGZ,Kyrgyzstan,1,0,0,1
2020,2000,TGA,Tonga,0,0,0,0
2021,2000,TAN,Tanzania,0,0,0,0
2022,2000,SYR,Syria,0,0,0,0
2023,2000,SWZ,Swaziland,0,0,0,0
2024,2000,PUR,Puerto Rico,0,0,0,0
2025,2000,QAT,Qatar,1,0,0,1
2026,2000,ROU,Romania,13,27,6,46
2027,2000,RSA,South Africa,3,0,2,5
2028,2000,RUS,Russia,54,66,67,187
2029,2000,RWA,Rwanda,0,0,0,0
2030,2000,SAM,Samoa,0,0,0,0
2031,2000,SCG,Serbia,13,11,1,25
2032,2000,SEN,Senegal,0,0,0,0
2033,2000,SEY,Seychelles,0,0,0,0
2034,2000,POR,Portugal,2,0,0,2
2035,2000,SKN,Saint Kitts,0,0,0,0
2036,2000,SLO,Slovenia,0,3,0,3
2037,2000,SMR,San Marino,0,0,0,0
2038,2000,SOL,Solomon Islands,0,0,0,0
2039,2000,SRI,Sri Lanka,0,0,1,1
2040,2000,STP,Sao Tome and Principe,0,0,0,0
2041,2000,SUD,Sudan,0,0,0,0
2042,2000,SUI,Switzerland,2,1,11,14
2043,2000,SUR,Suriname,0,0,0,0
2044,2000,SVK,Slovakia,1,2,3,6
2045,2000,SWE,Sweden,8,4,20,32
2046,2000,SLE,Sierra Leone,0,0,0,0
2047,2000,KEN,Kenya,2,2,3,7
2048,2000,LBA,Libya,0,0,0,0
2049,2000,JPN,Japan,8,5,31,44
2050,2000,BOL,Boliva,0,0,0,0
2051,2000,BOT,Botswana,0,0,0,0
2052,2000,BRA,Brazil,36,0,12,48
2053,2000,BRN,Bahrain,0,0,0,0
2054,2000,BRU,Brunei,0,0,0,0
2055,2000,BUR,Burkina Faso,0,0,0,0
2056,2000,CAF,Central African Republic,0,0,0,0
2057,2000,CAM,Cambodia,0,0,0,0
2058,2000,CAN,Canada,23,4,4,31
2059,2000,CAY,Cayman Islands,0,0,0,0
2060,2000,CGO,Republic of Congo,0,0,0,0
2061,2000,CHA,Chad,0,0,0,0
2062,2000,CHI,Chile,17,0,0,17
2063,2000,CHN,China,17,39,23,79
2064,2000,CIV,Ivory Coast,0,0,0,0
2065,2000,CMR,Cameroon,0,18,0,18
2066,2000,COD,Democratic Republic of the Congo,0,0,0,0
2067,2000,COK,Cook Islands,0,0,0,0
2068,2000,COL,Colombia,0,1,0,1
2069,2000,COM,Comoros,0,0,0,0
2070,2000,CPV,Cape Verde,0,0,0,0
2071,2000,BLR,Belarus,11,3,8,22
2072,2000,CRC,Costa Rica,2,0,0,2
2073,2000,BIZ,Belize,0,0,0,0
2074,2000,BHU,Bhutan,0,0,0,0
2075,2000,KAZ,Kazakhstan,0,3,4,7
2076,2000,AHO,Curacao,0,0,0,0
2077,2000,ALB,Albania,0,0,0,0
2078,2000,ALG,Algeria,3,1,1,5
2079,2000,AND,Andorra,0,0,0,0
2080,2000,ANG,Angola,0,0,0,0
2081,2000,ANT,Antigua,0,0,0,0
2082,2000,ARG,Argentina,3,0,17,20
2083,2000,ARM,Armenia,1,0,0,1
2084,2000,ARU,Aruba,0,0,0,0
2085,2000,ASA,American Samoa,0,0,0,0
2086,2000,AUS,Australia,54,60,69,183
2087,2000,AUT,Austria,0,3,1,4
2088,2000,AZE,Azerbaijan,1,2,0,3
2089,2000,BAH,Bahamas,5,6,0,11
2090,2000,BAN,Bangladesh,0,0,0,0
2091,2000,BAR,Barbados,1,0,0,1
2092,2000,BDI,Burundi,0,0,0,0
2093,2000,BEL,Belgium,4,0,3,7
2094,2000,BEN,Benin,0,0,0,0
2095,2000,BER,Bermuda,0,0,0,0
2096,2000,BIH,Bosnia and Herzegovina,0,0,0,0
2097,2000,CRO,Croatia,9,1,0,10
2098,2000,BUL,Bulgaria,2,5,6,13
2099,2000,CYP,Cyprus,0,0,0,0
2100,2000,GRN,Grenada,0,0,0,0
2101,2000,GUA,Guatemala,0,0,0,0
2102,2000,GUI,Guinea,0,0,0,0
2103,2000,GUM,Guam,0,0,0,0
2104,2000,GUY,Guyana,0,0,0,0
2105,2000,HAI,Haiti,0,0,0,0
2106,2000,HKG,China,0,0,0,0
2107,2000,HON,Honduras,0,0,0,0
2108,2000,HUN,Hungary,4,25,24,53
2109,2000,INA,Indonesia,2,2,4,8
2110,2000,GRE,Greece,8,4,6,18
2111,2000,IND,India,1,0,0,1
2112,2000,IRI,Iran,1,3,0,4
2113,2000,IRL,Ireland,0,0,1,1
2114,2000,IRQ,Iraq,0,0,0,0
2115,2000,ISL,Iceland,1,0,0,1
2116,2000,CUB,Cuba,12,18,35,65
2117,2000,ISV,"Virgin Islands, US",0,0,0,0
2118,2000,ITA,Italy,29,22,14,65
2119,2000,IVB,"Virgin Islands, British",0,0,0,0
2120,2000,JAM,Jamaica,3,0,20,23
2121,2000,JOR,Jordan,0,0,0,0
2122,2000,IOA,Individual Olympic Athletes,0,0,0,0
2123,2000,GHA,Ghana,0,0,0,0
2124,2000,ISR,Israel,1,0,0,1
2125,2000,GEQ,Equatorial Guinea,0,0,0,0
2126,2000,GER,Germany,64,31,23,118
2127,2000,CZE,Czech Republic,4,2,3,9
2128,2000,DEN,Denmark,4,18,3,25
2129,2000,DMA,Dominica,0,0,0,0
2130,2000,DOM,Dominican Republic,0,0,0,0
2131,2000,ECU,Ecuador,0,0,0,0
2132,2000,EGY,Egypt,0,0,0,0
2133,2000,ERI,Eritrea,0,0,0,0
2134,2000,ESA,El Salvador,0,0,0,0
2135,2000,ESP,Spain,20,3,19,42
2136,2000,EST,Estonia,2,1,0,3
2137,2000,DJI,Djibouti,0,0,0,0
2138,2000,FIJ,Fiji,0,0,0,0
2139,2000,ETH,Ethiopia,3,4,1,8
2140,2000,GBS,Guinea-Bissau,0,0,0,0
2141,2000,GAM,Gambia,0,0,0,0
2142,2000,GBR,UK,12,22,20,54
2143,2000,FSM,Micronesia,0,0,0,0
2144,2000,FRA,France,14,22,30,66
2145,2000,FIN,Finland,1,3,1,5
2146,2000,GAB,Gabon,0,0,0,0
2147,2000,GEO,Georgia,6,0,0,6
2148,2002,NOR,Norway,7,23,11,41
2149,2002,NEP,Nepal,0,0,0,0
2150,2002,MDA,Moldova,0,0,0,0
2151,2002,NED,Netherlands,0,3,5,8
2152,2002,MON,Monaco,0,0,0,0
2153,2002,MKD,Macedonia,0,0,0,0
2154,2002,MGL,Mongolia,0,0,0,0
2155,2002,MEX,Mexico,0,0,0,0
2156,2002,LAT,Latvia,0,0,0,0
2157,2002,LIE,Liechtenstein,0,0,0,0
2158,2002,LIB,Lebanon,0,0,0,0
2159,2002,KOR,South Korea,0,5,2,7
2160,2002,KGZ,Kyrgyzstan,0,0,0,0
2161,2002,KEN,Kenya,0,0,0,0
2162,2002,NZL,New Zealand,0,0,0,0
2163,2002,KAZ,Kazakhstan,0,0,0,0
2164,2002,LTU,Lithuania,0,0,0,0
2165,2002,POL,Poland,1,0,1,2
2166,2002,TJK,Tajikistan,0,0,0,0
2167,2002,RSA,South Africa,0,0,0,0
2168,2002,JPN,Japan,1,0,1,2
2169,2002,VEN,Venezuela,0,0,0,0
2170,2002,UZB,Uzbekistan,0,0,0,0
2171,2002,USA,USA,15,11,58,84
2172,2002,UKR,Ukraine,0,0,0,0
2173,2002,TUR,Turkey,0,0,0,0
2174,2002,TTO,Trinidad,0,0,0,0
2175,2002,ROU,Romania,0,0,0,0
2176,2002,TPE,Taiwan,0,0,0,0
2177,2002,SWE,Sweden,24,0,2,26
2178,2002,SVK,Slovakia,0,0,0,0
2179,2002,SUI,Switzerland,14,3,7,24
2180,2002,SMR,San Marino,0,0,0,0
2181,2002,SLO,Slovenia,4,0,0,4
2182,2002,SCG,Serbia,0,0,0,0
2183,2002,RUS,Russia,27,6,5,38
2184,2002,THA,Thailand,0,0,0,0
2185,2002,JAM,Jamaica,0,0,0,0
2186,2002,ITA,Italy,6,4,11,21
2187,2002,ISV,"Virgin Islands, US",0,0,0,0
2188,2002,CRC,Costa Rica,0,0,0,0
2189,2002,CMR,Cameroon,0,0,0,0
2190,2002,CHN,China,9,2,5,16
2191,2002,CHI,Chile,0,0,0,0
2192,2002,CAN,Canada,15,52,7,74
2193,2002,BUL,Bulgaria,2,0,1,3
2194,2002,BRA,Brazil,0,0,0,0
2195,2002,CRO,Croatia,0,3,1,4
2196,2002,BLR,Belarus,1,0,0,1
2197,2002,BEL,Belgium,0,0,0,0
2198,2002,AZE,Azerbaijan,0,0,0,0
2199,2002,AUT,Austria,13,3,4,20
2200,2002,AUS,Australia,0,2,0,2
2201,2002,ARM,Armenia,0,0,0,0
2202,2002,ARG,Argentina,0,0,0,0
2203,2002,AND,Andorra,0,0,0,0
2204,2002,BIH,Bosnia and Herzegovina,0,0,0,0
2205,2002,CYP,Cyprus,0,0,0,0
2206,2002,BER,Bermuda,0,0,0,0
2207,2002,DEN,Denmark,0,0,0,0
2208,2002,CZE,Czech Republic,0,1,2,3
2209,2002,ISR,Israel,0,0,0,0
2210,2002,ISL,Iceland,0,0,0,0
2211,2002,IRL,Ireland,0,0,0,0
2212,2002,IRI,Iran,0,0,0,0
2213,2002,HUN,Hungary,0,0,0,0
2214,2002,HKG,China,0,0,0,0
2215,2002,GRE,Greece,0,0,0,0
2216,2002,IND,India,0,0,0,0
2217,2002,GEO,Georgia,0,0,0,0
2218,2002,GBR,UK,1,5,0,6
2219,2002,FRA,France,5,5,5,15
2220,2002,FIN,Finland,1,7,5,13
2221,2002,FIJ,Fiji,0,0,0,0
2222,2002,EST,Estonia,1,1,1,3
2223,2002,GER,Germany,12,26,23,61
2224,2002,ESP,Spain,0,0,0,0
2225,2004,MTN,Mauritania,0,0,0,0
2226,2004,NIG,Niger,0,0,0,0
2227,2004,NGR,Nigeria,8,0,0,8
2228,2004,NEP,Nepal,0,0,0,0
2229,2004,MYA,Myanmar,0,0,0,0
2230,2004,NCA,Nicaragua,0,0,0,0
2231,2004,NAM,Namibia,0,0,0,0
2232,2004,NOR,Norway,2,5,0,7
2233,2004,NED,Netherlands,22,4,51,77
2234,2004,NRU,Nauru,0,0,0,0
2235,2004,PLW,Palau,0,0,0,0
2236,2004,OMA,Oman,0,0,0,0
2237,2004,PAK,Pakistan,0,0,0,0
2238,2004,PAN,Panama,0,0,0,0
2239,2004,PAR,Paraguay,0,0,17,17
2240,2004,PER,Peru,0,0,0,0
2241,2004,PHI,Philippines,0,0,0,0
2242,2004,PLE,Palestine,0,0,0,0
2243,2004,PNG,Papua New Guinea,0,0,0,0
2244,2004,POL,Poland,6,4,2,12
2245,2004,MRI,Mauritius,0,0,0,0
2246,2004,NZL,New Zealand,0,4,2,6
2247,2004,MOZ,Mozambique,0,0,0,0
2248,2004,LBR,Liberia,0,0,0,0
2249,2004,MLT,Malta,0,0,0,0
2250,2004,KSA,Saudi Arabia,0,0,0,0
2251,2004,KUW,Kuwait,0,0,0,0
2252,2004,LAO,Laos,0,0,0,0
2253,2004,LAT,Latvia,0,0,4,4
2254,2004,LBA,Libya,0,0,0,0
2255,2004,POR,Portugal,1,0,2,3
2256,2004,LCA,Saint Lucia,0,0,0,0
2257,2004,LES,Lesotho,0,0,0,0
2258,2004,LIB,Lebanon,0,0,0,0
2259,2004,LIE,Liechtenstein,0,0,0,0
2260,2004,MON,Monaco,0,0,0,0
2261,2004,LTU,Lithuania,0,1,2,3
2262,2004,MAD,Madagascar,0,0,0,0
2263,2004,MAR,Morocco,0,2,1,3
2264,2004,MAS,Malaysia,0,0,0,0
2265,2004,MAW,Malawi,0,0,0,0
2266,2004,MDA,Moldova,0,0,0,0
2267,2004,MDV,Maldives,0,0,0,0
2268,2004,MEX,Mexico,1,0,3,4
2269,2004,MGL,Mongolia,1,0,0,1
2270,2004,MKD,Macedonia,0,0,0,0
2271,2004,MLI,Mali,0,0,0,0
2272,2004,LUX,Luxembourg,0,0,0,0
2273,2004,PRK,North Korea,1,0,4,5
2274,2004,STP,Sao Tome and Principe,0,0,0,0
2275,2004,QAT,Qatar,0,0,0,0
2276,2004,THA,Thailand,4,3,1,8
2277,2004,TJK,Tajikistan,0,0,0,0
2278,2004,TKM,Turkmenistan,0,0,0,0
2279,2004,TLS,Timor-Leste,0,0,0,0
2280,2004,TOG,Togo,0,0,0,0
2281,2004,TPE,Taiwan,3,2,4,9
2282,2004,TTO,Trinidad,1,0,0,1
2283,2004,TUN,Tunisia,0,0,0,0
2284,2004,TUR,Turkey,5,3,3,11
2285,2004,UAE,United Arab Emirates,0,1,0,1
2286,2004,UGA,Uganda,0,0,0,0
2287,2004,UKR,Ukraine,31,8,8,47
2288,2004,URU,Uruguay,0,0,0,0
2289,2004,USA,USA,71,117,75,7
2290,2004,UZB,Uzbekistan,2,2,1,5
2291,2004,VAN,Vanuatu,0,0,0,0
2292,2004,VEN,Venezuela,2,0,0,2
2293,2004,VIE,Vietnam,0,0,0,0
2294,2004,VIN,Saint Vincent,0,0,0,0
2295,2004,YEM,Yemen,0,0,0,0
2296,2004,ZAM,Zambia,0,0,0,0
2297,2004,TGA,Tonga,0,0,0,0
2298,2004,TAN,Tanzania,0,0,0,0
2299,2004,SYR,Syria,1,0,0,1
2300,2004,SWZ,Swaziland,0,0,0,0
2301,2004,ROU,Romania,11,23,5,39
2302,2004,RSA,South Africa,3,4,3,10
2303,2004,RUS,Russia,95,48,46,189
2304,2004,RWA,Rwanda,0,0,0,0
2305,2004,SAM,Samoa,0,0,0,0
2306,2004,SCG,Serbia,0,0,13,13
2307,2004,SEN,Senegal,0,0,0,0
2308,2004,SEY,Seychelles,0,0,0,0
2309,2004,SKN,Saint Kitts,0,0,0,0
2310,2004,SLE,Sierra Leone,0,0,0,0
2311,2004,PUR,Puerto Rico,0,0,0,0
2312,2004,SLO,Slovenia,3,0,2,5
2313,2004,SOL,Solomon Islands,0,0,0,0
2314,2004,SOM,Somalia,0,0,0,0
2315,2004,SRI,Sri Lanka,0,0,0,0
2316,2004,ZIM,Zimbabwe,1,1,1,3
2317,2004,KOR,South Korea,10,14,28,52
2318,2004,SUD,Sudan,0,0,0,0
2319,2004,SUI,Switzerland,4,1,2,7
2320,2004,SUR,Suriname,0,0,0,0
2321,2004,SVK,Slovakia,5,3,2,10
2322,2004,SWE,Sweden,2,5,5,12
2323,2004,SMR,San Marino,0,0,0,0
2324,2004,KIR,Kiribati,0,0,0,0
2325,2004,BUR,Burkina Faso,0,0,0,0
2326,2004,KEN,Kenya,2,1,4,7
2327,2004,BOL,Boliva,0,0,0,0
2328,2004,BOT,Botswana,0,0,0,0
2329,2004,BRA,Brazil,3,18,19,40
2330,2004,BRN,Bahrain,0,0,0,0
2331,2004,KGZ,Kyrgyzstan,0,0,0,0
2332,2004,BUL,Bulgaria,14,2,1,17
2333,2004,CAF,Central African Republic,0,0,0,0
2334,2004,CAM,Cambodia,0,0,0,0
2335,2004,CAN,Canada,4,3,10,17
2336,2004,CAY,Cayman Islands,0,0,0,0
2337,2004,CGO,Republic of Congo,0,0,0,0
2338,2004,CHA,Chad,0,0,0,0
2339,2004,CHI,Chile,1,3,0,4
2340,2004,CHN,China,15,52,27,94
2341,2004,CIV,Ivory Coast,0,0,0,0
2342,2004,CMR,Cameroon,0,1,0,1
2343,2004,COD,Democratic Republic of the Congo,0,0,0,0
2344,2004,COK,Cook Islands,0,0,0,0
2345,2004,COL,Colombia,2,0,0,2
2346,2004,COM,Comoros,0,0,0,0
2347,2004,CPV,Cape Verde,0,0,0,0
2348,2004,BLR,Belarus,8,2,5,15
2349,2004,CRC,Costa Rica,0,0,0,0
2350,2004,BIZ,Belize,0,0,0,0
2351,2004,BHU,Bhutan,0,0,0,0
2352,2004,AFG,Afghanistan,0,0,0,0
2353,2004,AHO,Curacao,0,0,0,0
2354,2004,ALB,Albania,0,0,0,0
2355,2004,ALG,Algeria,0,0,0,0
2356,2004,AND,Andorra,0,0,0,0
2357,2004,ANG,Angola,0,0,0,0
2358,2004,ANT,Antigua,0,0,0,0
2359,2004,ARG,Argentina,21,28,0,49
2360,2004,ARM,Armenia,0,0,0,0
2361,2004,ARU,Aruba,0,0,0,0
2362,2004,ASA,American Samoa,0,0,0,0
2363,2004,AUS,Australia,31,49,77,157
2364,2004,AUT,Austria,1,3,4,8
2365,2004,AZE,Azerbaijan,4,1,0,5
2366,2004,BAH,Bahamas,1,1,0,2
2367,2004,BAN,Bangladesh,0,0,0,0
2368,2004,BAR,Barbados,0,0,0,0
2369,2004,BDI,Burundi,0,0,0,0
2370,2004,BEL,Belgium,2,1,0,3
2371,2004,BEN,Benin,0,0,0,0
2372,2004,BER,Bermuda,0,0,0,0
2373,2004,BIH,Bosnia and Herzegovina,0,0,0,0
2374,2004,CRO,Croatia,3,15,3,21
2375,2004,BRU,Brunei,0,0,0,0
2376,2004,CYP,Cyprus,0,0,0,0
2377,2004,GUI,Guinea,0,0,0,0
2378,2004,GUM,Guam,0,0,0,0
2379,2004,GUY,Guyana,0,0,0,0
2380,2004,HAI,Haiti,0,0,0,0
2381,2004,HKG,China,0,0,2,2
2382,2004,HON,Honduras,0,0,0,0
2383,2004,HUN,Hungary,4,24,12,40
2384,2004,INA,Indonesia,3,1,1,5
2385,2004,IND,India,0,0,1,1
2386,2004,IRI,Iran,2,2,2,6
2387,2004,IRL,Ireland,0,0,0,0
2388,2004,IRQ,Iraq,0,0,0,0
2389,2004,ISL,Iceland,0,0,0,0
2390,2004,ISR,Israel,1,1,0,2
2391,2004,ISV,"Virgin Islands, US",0,0,0,0
2392,2004,ITA,Italy,39,24,41,104
2393,2004,CUB,Cuba,22,32,8,62
2394,2004,JAM,Jamaica,6,6,1,13
2395,2004,JOR,Jordan,0,0,0,0
2396,2004,JPN,Japan,52,21,20,93
2397,2004,KAZ,Kazakhstan,3,1,4,8
2398,2004,GUA,Guatemala,0,0,0,0
2399,2004,GRN,Grenada,0,0,0,0
2400,2004,IVB,"Virgin Islands, British",0,0,0,0
2401,2004,GHA,Ghana,0,0,0,0
2402,2004,GRE,Greece,5,8,18,31
2403,2004,CZE,Czech Republic,6,1,6,13
2404,2004,DEN,Denmark,9,19,1,29
2405,2004,DOM,Dominican Republic,0,1,0,1
2406,2004,ECU,Ecuador,0,0,0,0
2407,2004,EGY,Egypt,3,1,1,5
2408,2004,ERI,Eritrea,1,0,0,1
2409,2004,ESA,El Salvador,0,0,0,0
2410,2004,ESP,Spain,9,4,17,30
2411,2004,EST,Estonia,2,0,1,3
2412,2004,ETH,Ethiopia,2,2,3,7
2413,2004,DMA,Dominica,0,0,0,0
2414,2004,FIN,Finland,0,0,2,2
2415,2004,FIJ,Fiji,0,0,0,0
2416,2004,GEO,Georgia,0,2,2,4
2417,2004,GBS,Guinea-Bissau,0,0,0,0
2418,2004,GBR,UK,15,17,25,57
2419,2004,GEQ,Equatorial Guinea,0,0,0,0
2420,2004,GAB,Gabon,0,0,0,0
2421,2004,FSM,Micronesia,0,0,0,0
2422,2004,FRA,France,22,21,10,53
2423,2004,GAM,Gambia,0,0,0,0
2424,2004,GER,Germany,63,41,45,149
2425,2006,NOR,Norway,12,2,9,23
2426,2006,MAD,Madagascar,0,0,0,0
2427,2006,NEP,Nepal,0,0,0,0
2428,2006,NED,Netherlands,8,3,2,13
2429,2006,MON,Monaco,0,0,0,0
2430,2006,MKD,Macedonia,0,0,0,0
2431,2006,MGL,Mongolia,0,0,0,0
2432,2006,MDA,Moldova,0,0,0,0
2433,2006,LIB,Lebanon,0,0,0,0
2434,2006,LTU,Lithuania,0,0,0,0
2435,2006,LIE,Liechtenstein,0,0,0,0
2436,2006,LAT,Latvia,1,0,0,1
2437,2006,KOR,South Korea,2,14,3,19
2438,2006,KGZ,Kyrgyzstan,0,0,0,0
2439,2006,KEN,Kenya,0,0,0,0
2440,2006,NZL,New Zealand,0,0,0,0
2441,2006,LUX,Luxembourg,0,0,0,0
2442,2006,POL,Poland,1,0,1,2
2443,2006,SWE,Sweden,8,35,21,64
2444,2006,PRK,North Korea,0,0,0,0
2445,2006,VEN,Venezuela,0,0,0,0
2446,2006,UZB,Uzbekistan,0,0,0,0
2447,2006,USA,USA,32,9,11,52
2448,2006,UKR,Ukraine,3,0,0,3
2449,2006,TUR,Turkey,0,0,0,0
2450,2006,TPE,Taiwan,0,0,0,0
2451,2006,TJK,Tajikistan,0,0,0,0
2452,2006,THA,Thailand,0,0,0,0
2453,2006,SVK,Slovakia,0,0,1,1
2454,2006,SUI,Switzerland,9,5,7,21
2455,2006,SMR,San Marino,0,0,0,0
2456,2006,SLO,Slovenia,0,0,0,0
2457,2006,SEN,Senegal,0,0,0,0
2458,2006,SCG,Serbia,0,0,0,0
2459,2006,RUS,Russia,13,16,12,41
2460,2006,RSA,South Africa,0,0,0,0
2461,2006,ROU,Romania,0,0,0,0
2462,2006,POR,Portugal,0,0,0,0
2463,2006,JPN,Japan,0,1,0,1
2464,2006,KAZ,Kazakhstan,0,0,0,0
2465,2006,ISR,Israel,0,0,0,0
2466,2006,CHI,Chile,0,0,0,0
2467,2006,CAN,Canada,11,30,28,69
2468,2006,BUL,Bulgaria,0,0,1,1
2469,2006,BRA,Brazil,0,0,0,0
2470,2006,BLR,Belarus,0,0,1,1
2471,2006,BIH,Bosnia and Herzegovina,0,0,0,0
2472,2006,BER,Bermuda,0,0,0,0
2473,2006,CHN,China,6,2,5,13
2474,2006,BEL,Belgium,0,0,0,0
2475,2006,AUS,Australia,1,1,0,2
2476,2006,ARM,Armenia,0,0,0,0
2477,2006,ARG,Argentina,0,0,0,0
2478,2006,AND,Andorra,0,0,0,0
2479,2006,ALG,Algeria,0,0,0,0
2480,2006,ALB,Albania,0,0,0,0
2481,2006,ITA,Italy,14,11,0,25
2482,2006,AUT,Austria,7,16,7,30
2483,2006,CRC,Costa Rica,0,0,0,0
2484,2006,AZE,Azerbaijan,0,0,0,0
2485,2006,CYP,Cyprus,0,0,0,0
2486,2006,CRO,Croatia,0,1,2,3
2487,2006,ISL,Iceland,0,0,0,0
2488,2006,IRL,Ireland,0,0,0,0
2489,2006,IRI,Iran,0,0,0,0
2490,2006,IND,India,0,0,0,0
2491,2006,HKG,China,0,0,0,0
2492,2006,GRE,Greece,0,0,0,0
2493,2006,GER,Germany,6,23,25,54
2494,2006,HUN,Hungary,0,0,0,0
2495,2006,GBR,UK,0,0,1,1
2496,2006,FRA,France,10,3,2,15
2497,2006,FIN,Finland,7,0,34,41
2498,2006,ETH,Ethiopia,0,0,0,0
2499,2006,EST,Estonia,0,3,0,3
2500,2006,ESP,Spain,0,0,0,0
2501,2006,DEN,Denmark,0,0,0,0
2502,2006,GEO,Georgia,0,0,0,0
2503,2006,CZE,Czech Republic,24,1,2,27
2504,2008,MRI,Mauritius,1,0,0,1
2505,2008,NGR,Nigeria,7,0,16,23
2506,2008,NEP,Nepal,0,0,0,0
2507,2008,NED,Netherlands,4,39,18,61
2508,2008,MTN,Mauritania,0,0,0,0
2509,2008,NAM,Namibia,0,0,0,0
2510,2008,MYA,Myanmar,0,0,0,0
2511,2008,NIG,Niger,0,0,0,0
2512,2008,NCA,Nicaragua,0,0,0,0
2513,2008,NOR,Norway,1,16,5,22
2514,2008,PLW,Palau,0,0,0,0
2515,2008,NZL,New Zealand,9,4,2,15
2516,2008,OMA,Oman,0,0,0,0
2517,2008,PAK,Pakistan,0,0,0,0
2518,2008,PAN,Panama,0,1,0,1
2519,2008,PAR,Paraguay,0,0,0,0
2520,2008,PER,Peru,0,0,0,0
2521,2008,PHI,Philippines,0,0,0,0
2522,2008,PLE,Palestine,0,0,0,0
2523,2008,PNG,Papua New Guinea,0,0,0,0
2524,2008,MOZ,Mozambique,0,0,0,0
2525,2008,NRU,Nauru,0,0,0,0
2526,2008,MON,Monaco,0,0,0,0
2527,2008,LBR,Liberia,0,0,0,0
2528,2008,MLT,Malta,0,0,0,0
2529,2008,KUW,Kuwait,0,0,0,0
2530,2008,LAO,Laos,0,0,0,0
2531,2008,LAT,Latvia,1,1,1,3
2532,2008,LBA,Libya,0,0,0,0
2533,2008,POL,Poland,1,6,13,20
2534,2008,LCA,Saint Lucia,0,0,0,0
2535,2008,LES,Lesotho,0,0,0,0
2536,2008,LIB,Lebanon,0,0,0,0
2537,2008,LIE,Liechtenstein,0,0,0,0
2538,2008,LTU,Lithuania,3,0,2,5
2539,2008,MNE,Montenegro,0,0,0,0
2540,2008,LUX,Luxembourg,0,0,0,0
2541,2008,MAR,Morocco,1,0,1,2
2542,2008,MAS,Malaysia,0,0,1,1
2543,2008,MAW,Malawi,0,0,0,0
2544,2008,MDA,Moldova,1,0,0,1
2545,2008,MDV,Maldives,0,0,0,0
2546,2008,MEX,Mexico,2,2,0,4
2547,2008,MGL,Mongolia,0,2,2,4
2548,2008,MHL,Marshall Islands,0,0,0,0
2549,2008,MKD,Macedonia,0,0,0,0
2550,2008,MLI,Mali,0,0,0,0
2551,2008,MAD,Madagascar,0,0,0,0
2552,2008,POR,Portugal,0,1,1,2
2553,2008,STP,Sao Tome and Principe,0,0,0,0
2554,2008,PUR,Puerto Rico,0,0,0,0
2555,2008,TJK,Tajikistan,1,0,1,2
2556,2008,TKM,Turkmenistan,0,0,0,0
2557,2008,TLS,Timor-Leste,0,0,0,0
2558,2008,TOG,Togo,1,0,0,1
2559,2008,TPE,Taiwan,4,0,0,4
2560,2008,TTO,Trinidad,0,5,1,6
2561,2008,TUN,Tunisia,0,1,0,1
2562,2008,TUR,Turkey,3,1,3,7
2563,2008,UAE,United Arab Emirates,0,0,0,0
2564,2008,UGA,Uganda,0,0,0,0
2565,2008,UKR,Ukraine,16,10,5,31
2566,2008,URU,Uruguay,0,0,0,0
2567,2008,USA,USA,80,127,110,61
2568,2008,UZB,Uzbekistan,3,1,2,6
2569,2008,VAN,Vanuatu,0,0,0,0
2570,2008,VEN,Venezuela,1,0,0,1
2571,2008,VIE,Vietnam,0,0,1,1
2572,2008,VIN,Saint Vincent,0,0,0,0
2573,2008,YEM,Yemen,0,0,0,0
2574,2008,ZAM,Zambia,0,0,0,0
2575,2008,ZIM,Zimbabwe,0,1,3,4
2576,2008,THA,Thailand,0,2,2,4
2577,2008,TGA,Tonga,0,0,0,0
2578,2008,TAN,Tanzania,0,0,0,0
2579,2008,SYR,Syria,0,0,0,0
2580,2008,QAT,Qatar,0,0,0,0
2581,2008,ROU,Romania,16,5,1,22
2582,2008,RSA,South Africa,0,0,1,1
2583,2008,RUS,Russia,53,43,46,142
2584,2008,RWA,Rwanda,0,0,0,0
2585,2008,SAM,Samoa,0,0,0,0
2586,2008,SEN,Senegal,0,0,0,0
2587,2008,SEY,Seychelles,0,0,0,0
2588,2008,SKN,Saint Kitts,0,0,0,0
2589,2008,SLE,Sierra Leone,0,0,0,0
2590,2008,PRK,North Korea,3,2,1,6
2591,2008,SLO,Slovenia,2,1,2,5
2592,2008,SOL,Solomon Islands,0,0,0,0
2593,2008,SOM,Somalia,0,0,0,0
2594,2008,SRB,Serbia,14,0,1,15
2595,2008,SRI,Sri Lanka,0,0,0,0
2596,2008,KSA,Saudi Arabia,0,0,0,0
2597,2008,SUD,Sudan,0,0,1,1
2598,2008,SUR,Suriname,0,0,0,0
2599,2008,SVK,Slovakia,1,4,5,10
2600,2008,SWE,Sweden,2,0,5,7
2601,2008,SWZ,Swaziland,0,0,0,0
2602,2008,SMR,San Marino,0,0,0,0
2603,2008,KOR,South Korea,26,41,11,78
2604,2008,SUI,Switzerland,7,3,1,11
2605,2008,KGZ,Kyrgyzstan,1,0,1,2
2606,2008,BOT,Botswana,0,0,0,0
2607,2008,BRA,Brazil,30,14,34,78
2608,2008,BRN,Bahrain,0,0,0,0
2609,2008,BUR,Burkina Faso,0,0,0,0
2610,2008,CAF,Central African Republic,0,0,0,0
2611,2008,CAM,Cambodia,0,0,0,0
2612,2008,CAN,Canada,11,11,13,35
2613,2008,CAY,Cayman Islands,0,0,0,0
2614,2008,CGO,Republic of Congo,0,0,0,0
2615,2008,CHA,Chad,0,0,0,0
2616,2008,CHI,Chile,0,0,1,1
2617,2008,CHN,China,57,74,53,184
2618,2008,CIV,Ivory Coast,0,0,0,0
2619,2008,CMR,Cameroon,0,1,0,1
2620,2008,COD,Democratic Republic of the Congo,0,0,0,0
2621,2008,COK,Cook Islands,0,0,0,0
2622,2008,COL,Colombia,1,0,1,2
2623,2008,COM,Comoros,0,0,0,0
2624,2008,CPV,Cape Verde,0,0,0,0
2625,2008,CRC,Costa Rica,0,0,0,0
2626,2008,CRO,Croatia,3,0,2,5
2627,2008,BOL,Boliva,0,0,0,0
2628,2008,BLR,Belarus,16,8,5,29
2629,2008,BIZ,Belize,0,0,0,0
2630,2008,BIH,Bosnia and Herzegovina,0,0,0,0
2631,2008,AFG,Afghanistan,1,0,0,1
2632,2008,AHO,Curacao,0,0,0,0
2633,2008,ALB,Albania,0,0,0,0
2634,2008,ALG,Algeria,1,0,1,2
2635,2008,AND,Andorra,0,0,0,0
2636,2008,ANG,Angola,0,0,0,0
2637,2008,ANT,Antigua,0,0,0,0
2638,2008,ARG,Argentina,31,20,0,51
2639,2008,ARM,Armenia,6,0,0,6
2640,2008,ARU,Aruba,0,0,0,0
2641,2008,CUB,Cuba,11,2,34,47
2642,2008,ASA,American Samoa,0,0,0,0
2643,2008,AUT,Austria,2,0,1,3
2644,2008,AZE,Azerbaijan,4,1,2,7
2645,2008,BAH,Bahamas,1,0,6,7
2646,2008,BAN,Bangladesh,0,0,0,0
2647,2008,BAR,Barbados,0,0,0,0
2648,2008,BDI,Burundi,0,0,0,0
2649,2008,BEL,Belgium,0,1,4,5
2650,2008,BEN,Benin,0,0,0,0
2651,2008,BER,Bermuda,0,0,0,0
2652,2008,BHU,Bhutan,0,0,0,0
2653,2008,AUS,Australia,76,31,42,149
2654,2008,CYP,Cyprus,0,0,0,0
2655,2008,BUL,Bulgaria,3,1,1,5
2656,2008,DEN,Denmark,6,6,7,19
2657,2008,GUI,Guinea,0,0,0,0
2658,2008,GUM,Guam,0,0,0,0
2659,2008,GUY,Guyana,0,0,0,0
2660,2008,HAI,Haiti,0,0,0,0
2661,2008,HKG,China,0,0,0,0
2662,2008,HON,Honduras,0,0,0,0
2663,2008,HUN,Hungary,3,16,8,27
2664,2008,INA,Indonesia,3,2,2,7
2665,2008,IND,India,2,1,0,3
2666,2008,IRI,Iran,1,1,0,2
2667,2008,GUA,Guatemala,0,0,0,0
2668,2008,IRL,Ireland,2,0,1,3
2669,2008,ISL,Iceland,0,0,14,14
2670,2008,ISR,Israel,1,0,0,1
2671,2008,ISV,"Virgin Islands, US",0,0,0,0
2672,2008,ITA,Italy,20,8,14,42
2673,2008,IVB,"Virgin Islands, British",0,0,0,0
2674,2008,CZE,Czech Republic,0,3,4,7
2675,2008,JOR,Jordan,0,0,0,0
2676,2008,JPN,Japan,13,23,15,51
2677,2008,KAZ,Kazakhstan,7,2,4,13
2678,2008,KEN,Kenya,5,6,4,15
2679,2008,IRQ,Iraq,0,0,0,0
2680,2008,GRN,Grenada,0,0,0,0
2681,2008,JAM,Jamaica,6,5,3,14
2682,2008,GHA,Ghana,0,0,0,0
2683,2008,GRE,Greece,4,0,3,7
2684,2008,DJI,Djibouti,0,0,0,0
2685,2008,DMA,Dominica,0,0,0,0
2686,2008,DOM,Dominican Republic,0,1,1,2
2687,2008,ECU,Ecuador,0,0,1,1
2688,2008,EGY,Egypt,1,0,0,1
2689,2008,ERI,Eritrea,0,0,0,0
2690,2008,ESA,El Salvador,0,0,0,0
2691,2008,ESP,Spain,16,7,47,70
2692,2008,EST,Estonia,0,1,2,3
2693,2008,ETH,Ethiopia,2,4,1,7
2694,2008,FIJ,Fiji,0,0,0,0
2695,2008,KIR,Kiribati,0,0,0,0
2696,2008,FRA,France,28,25,24,77
2697,2008,GEQ,Equatorial Guinea,0,0,0,0
2698,2008,FIN,Finland,2,1,2,5
2699,2008,GBS,Guinea-Bissau,0,0,0,0
2700,2008,GEO,Georgia,3,3,0,6
2701,2008,GAM,Gambia,0,0,0,0
2702,2008,GAB,Gabon,0,0,0,0
2703,2008,FSM,Micronesia,0,0,0,0
2704,2008,GBR,UK,25,31,25,81
2705,2008,GER,Germany,41,42,16,99
2706,2010,NEP,Nepal,0,0,0,0
2707,2010,MEX,Mexico,0,0,0,0
2708,2010,NED,Netherlands,6,4,1,11
2709,2010,MON,Monaco,0,0,0,0
2710,2010,MNE,Montenegro,0,0,0,0
2711,2010,MKD,Macedonia,0,0,0,0
2712,2010,MGL,Mongolia,0,0,0,0
2713,2010,LIE,Liechtenstein,0,0,0,0
2714,2010,MAR,Morocco,0,0,0,0
2715,2010,LTU,Lithuania,0,0,0,0
2716,2010,NOR,Norway,9,16,14,39
2717,2010,LIB,Lebanon,0,0,0,0
2718,2010,LAT,Latvia,0,0,3,3
2719,2010,KOR,South Korea,2,6,10,18
2720,2010,KGZ,Kyrgyzstan,0,0,0,0
2721,2010,KAZ,Kazakhstan,0,0,1,1
2722,2010,JPN,Japan,2,0,5,7
2723,2010,MDA,Moldova,0,0,0,0
2724,2010,NZL,New Zealand,0,0,0,0
2725,2010,PRK,North Korea,0,0,0,0
2726,2010,PER,Peru,0,0,0,0
2727,2010,JAM,Jamaica,0,0,0,0
2728,2010,UZB,Uzbekistan,0,0,0,0
2729,2010,USA,USA,22,12,63,97
2730,2010,UKR,Ukraine,0,0,0,0
2731,2010,TUR,Turkey,0,0,0,0
2732,2010,TPE,Taiwan,0,0,0,0
2733,2010,TJK,Tajikistan,0,0,0,0
2734,2010,SWE,Sweden,4,11,3,18
2735,2010,PAK,Pakistan,0,0,0,0
2736,2010,SVK,Slovakia,1,1,1,3
2737,2010,SMR,San Marino,0,0,0,0
2738,2010,SLO,Slovenia,1,0,2,3
2739,2010,SEN,Senegal,0,0,0,0
2740,2010,RUS,Russia,14,6,5,25
2741,2010,RSA,South Africa,0,0,0,0
2742,2010,ROU,Romania,0,0,0,0
2743,2010,POR,Portugal,0,0,0,0
2744,2010,POL,Poland,4,1,3,8
2745,2010,SUI,Switzerland,6,6,0,12
2746,2010,SRB,Serbia,0,0,0,0
2747,2010,ITA,Italy,3,1,1,5
2748,2010,ISL,Iceland,0,0,0,0
2749,2010,CHI,Chile,0,0,0,0
2750,2010,CAY,Cayman Islands,0,0,0,0
2751,2010,CAN,Canada,8,67,15,90
2752,2010,BUL,Bulgaria,0,0,0,0
2753,2010,BRA,Brazil,0,0,0,0
2754,2010,BLR,Belarus,1,1,1,3
2755,2010,BIH,Bosnia and Herzegovina,0,0,0,0
2756,2010,BER,Bermuda,0,0,0,0
2757,2010,BEL,Belgium,0,0,0,0
2758,2010,AUT,Austria,6,11,9,26
2759,2010,AUS,Australia,0,2,1,3
2760,2010,ARM,Armenia,0,0,0,0
2761,2010,ARG,Argentina,0,0,0,0
2762,2010,AND,Andorra,0,0,0,0
2763,2010,ALG,Algeria,0,0,0,0
2764,2010,ALB,Albania,0,0,0,0
2765,2010,ISR,Israel,0,0,0,0
2766,2010,CHN,China,7,9,3,19
2767,2010,COL,Colombia,0,0,0,0
2768,2010,AZE,Azerbaijan,0,0,0,0
2769,2010,CYP,Cyprus,0,0,0,0
2770,2010,IRL,Ireland,0,0,0,0
2771,2010,CRO,Croatia,1,0,2,3
2772,2010,IRI,Iran,0,0,0,0
2773,2010,IND,India,0,0,0,0
2774,2010,HUN,Hungary,0,0,0,0
2775,2010,GRE,Greece,0,0,0,0
2776,2010,GHA,Ghana,0,0,0,0
2777,2010,GER,Germany,15,15,24,54
2778,2010,HKG,China,0,0,0,0
2779,2010,GBR,UK,0,1,0,1
2780,2010,FRA,France,6,2,6,14
2781,2010,FIN,Finland,46,0,1,47
2782,2010,ETH,Ethiopia,0,0,0,0
2783,2010,EST,Estonia,0,0,1,1
2784,2010,ESP,Spain,0,0,0,0
2785,2010,GEO,Georgia,0,0,0,0
2786,2010,DEN,Denmark,0,0,0,0
2787,2010,CZE,Czech Republic,7,2,0,9
2788,2012,MOZ,Mozambique,0,0,0,0
2789,2012,NEP,Nepal,0,0,0,0
2790,2012,NED,Netherlands,19,21,29,69
2791,2012,NCA,Nicaragua,0,0,0,0
2792,2012,MTN,Mauritania,0,0,0,0
2793,2012,MYA,Myanmar,0,0,0,0
2794,2012,MRI,Mauritius,0,0,0,0
2795,2012,NGR,Nigeria,0,0,0,0
2796,2012,NAM,Namibia,0,0,0,0
2797,2012,NIG,Niger,0,0,0,0
2798,2012,PHI,Philippines,0,0,0,0
2799,2012,NRU,Nauru,0,0,0,0
2800,2012,NZL,New Zealand,15,9,3,27
2801,2012,OMA,Oman,0,0,0,0
2802,2012,PAK,Pakistan,0,0,0,0
2803,2012,PAN,Panama,0,0,0,0
2804,2012,PAR,Paraguay,0,0,0,0
2805,2012,PER,Peru,0,0,0,0
2806,2012,PLE,Palestine,0,0,0,0
2807,2012,PLW,Palau,0,0,0,0
2808,2012,MON,Monaco,0,0,0,0
2809,2012,NOR,Norway,1,15,1,17
2810,2012,MNE,Montenegro,0,0,14,14
2811,2012,LCA,Saint Lucia,0,0,0,0
2812,2012,MLI,Mali,0,0,0,0
2813,2012,KUW,Kuwait,1,0,0,1
2814,2012,LAO,Laos,0,0,0,0
2815,2012,LAT,Latvia,2,1,0,3
2816,2012,LBA,Libya,0,0,0,0
2817,2012,LBR,Liberia,0,0,0,0
2818,2012,PNG,Papua New Guinea,0,0,0,0
2819,2012,LES,Lesotho,0,0,0,0
2820,2012,LIB,Lebanon,0,0,0,0
2821,2012,LIE,Liechtenstein,0,0,0,0
2822,2012,LTU,Lithuania,2,2,1,5
2823,2012,MLT,Malta,0,0,0,0
2824,2012,LUX,Luxembourg,0,0,0,0
2825,2012,ZIM,Zimbabwe,0,0,0,0
2826,2012,MAR,Morocco,1,0,0,1
2827,2012,MAS,Malaysia,1,0,1,2
2828,2012,MAW,Malawi,0,0,0,0
2829,2012,MDA,Moldova,2,0,0,2
2830,2012,MDV,Maldives,0,0,0,0
2831,2012,MEX,Mexico,3,16,5,24
2832,2012,MGL,Mongolia,3,0,2,5
2833,2012,MHL,Marshall Islands,0,0,0,0
2834,2012,MKD,Macedonia,0,0,0,0
2835,2012,MAD,Madagascar,0,0,0,0
2836,2012,POL,Poland,8,2,2,12
2837,2012,STP,Sao Tome and Principe,0,0,0,0
2838,2012,PRK,North Korea,2,4,0,6
2839,2012,THA,Thailand,1,0,2,3
2840,2012,TJK,Tajikistan,1,0,0,1
2841,2012,TKM,Turkmenistan,0,0,0,0
2842,2012,TLS,Timor-Leste,0,0,0,0
2843,2012,TOG,Togo,0,0,0,0
2844,2012,TPE,Taiwan,1,0,1,2
2845,2012,TTO,Trinidad,5,1,4,10
2846,2012,TUN,Tunisia,1,1,1,3
2847,2012,TUR,Turkey,1,2,2,5
2848,2012,UAE,United Arab Emirates,0,0,0,0
2849,2012,TGA,Tonga,0,0,0,0
2850,2012,UGA,Uganda,0,1,0,1
2851,2012,URU,Uruguay,0,0,0,0
2852,2012,USA,USA,46,145,57,248
2853,2012,UZB,Uzbekistan,2,1,0,3
2854,2012,VAN,Vanuatu,0,0,0,0
2855,2012,VEN,Venezuela,0,1,0,1
2856,2012,VIE,Vietnam,0,0,0,0
2857,2012,VIN,Saint Vincent,0,0,0,0
2858,2012,YEM,Yemen,0,0,0,0
2859,2012,ZAM,Zambia,0,0,0,0
2860,2012,KSA,Saudi Arabia,4,0,0,4
2861,2012,UKR,Ukraine,12,9,5,26
2862,2012,POR,Portugal,0,0,2,2
2863,2012,TAN,Tanzania,0,0,0,0
2864,2012,SWZ,Swaziland,0,0,0,0
2865,2012,PUR,Puerto Rico,1,0,1,2
2866,2012,QAT,Qatar,2,0,0,2
2867,2012,ROU,Romania,6,2,8,16
2868,2012,RSA,South Africa,1,6,2,9
2869,2012,RUS,Russia,51,50,39,140
2870,2012,RWA,Rwanda,0,0,0,0
2871,2012,SAM,Samoa,0,0,0,0
2872,2012,SEN,Senegal,0,0,0,0
2873,2012,SEY,Seychelles,0,0,0,0
2874,2012,SKN,Saint Kitts,0,0,0,0
2875,2012,SYR,Syria,0,0,0,0
2876,2012,SLE,Sierra Leone,0,0,0,0
2877,2012,SMR,San Marino,0,0,0,0
2878,2012,SOL,Solomon Islands,0,0,0,0
2879,2012,SOM,Somalia,0,0,0,0
2880,2012,SRB,Serbia,14,1,1,16
2881,2012,SRI,Sri Lanka,0,0,0,0
2882,2012,SUD,Sudan,0,0,0,0
2883,2012,SUI,Switzerland,0,2,2,4
2884,2012,SUR,Suriname,0,0,0,0
2885,2012,SVK,Slovakia,4,0,1,5
2886,2012,SWE,Sweden,3,2,17,22
2887,2012,SLO,Slovenia,3,1,1,5
2888,2012,KOR,South Korea,30,18,13,61
2889,2012,IOA,Individual Olympic Athletes,0,0,0,0
2890,2012,KGZ,Kyrgyzstan,0,0,0,0
2891,2012,BOT,Botswana,0,0,1,1
2892,2012,BRA,Brazil,11,14,34,59
2893,2012,BRU,Brunei,0,0,0,0
2894,2012,BUL,Bulgaria,1,0,1,2
2895,2012,BUR,Burkina Faso,0,0,0,0
2896,2012,CAF,Central African Republic,0,0,0,0
2897,2012,CAM,Cambodia,0,0,0,0
2898,2012,CAN,Canada,33,1,21,55
2899,2012,CAY,Cayman Islands,0,0,0,0
2900,2012,CGO,Republic of Congo,0,0,0,0
2901,2012,CHA,Chad,0,0,0,0
2902,2012,CHI,Chile,0,0,0,0
2903,2012,CHN,China,29,56,40,125
2904,2012,CIV,Ivory Coast,0,0,0,0
2905,2012,CMR,Cameroon,0,0,0,0
2906,2012,COD,Democratic Republic of the Congo,0,0,0,0
2907,2012,COK,Cook Islands,0,0,0,0
2908,2012,COL,Colombia,4,1,3,8
2909,2012,COM,Comoros,0,0,0,0
2910,2012,CPV,Cape Verde,0,0,0,0
2911,2012,CRC,Costa Rica,0,0,0,0
2912,2012,BOL,Boliva,0,0,0,0
2913,2012,BLR,Belarus,8,3,12,23
2914,2012,BIZ,Belize,0,0,0,0
2915,2012,BIH,Bosnia and Herzegovina,0,0,0,0
2916,2012,KIR,Kiribati,0,0,0,0
2917,2012,AFG,Afghanistan,1,0,0,1
2918,2012,ALB,Albania,0,0,0,0
2919,2012,ALG,Algeria,0,1,0,1
2920,2012,AND,Andorra,0,0,0,0
2921,2012,ANG,Angola,0,0,0,0
2922,2012,ANT,Antigua,0,0,0,0
2923,2012,ARG,Argentina,3,1,15,19
2924,2012,ARM,Armenia,2,0,1,3
2925,2012,ARU,Aruba,0,0,0,0
2926,2012,CRO,Croatia,16,15,4,35
2927,2012,ASA,American Samoa,0,0,0,0
2928,2012,AUT,Austria,0,0,0,0
2929,2012,AZE,Azerbaijan,6,2,2,10
2930,2012,BAH,Bahamas,0,4,0,4
2931,2012,BAN,Bangladesh,0,0,0,0
2932,2012,BAR,Barbados,0,0,0,0
2933,2012,BDI,Burundi,0,0,0,0
2934,2012,BEL,Belgium,2,0,1,3
2935,2012,BEN,Benin,0,0,0,0
2936,2012,BER,Bermuda,0,0,0,0
2937,2012,BHU,Bhutan,0,0,0,0
2938,2012,AUS,Australia,59,18,37,114
2939,2012,CUB,Cuba,6,5,3,14
2940,2012,BRN,Bahrain,1,0,0,1
2941,2012,CZE,Czech Republic,6,4,4,14
2942,2012,GUI,Guinea,0,0,0,0
2943,2012,GUM,Guam,0,0,0,0
2944,2012,GUY,Guyana,0,0,0,0
2945,2012,HAI,Haiti,0,0,0,0
2946,2012,HKG,China,1,0,0,1
2947,2012,HON,Honduras,0,0,0,0
2948,2012,HUN,Hungary,6,12,8,26
2949,2012,INA,Indonesia,1,0,1,2
2950,2012,IND,India,4,0,2,6
2951,2012,IRI,Iran,3,4,5,12
2952,2012,GUA,Guatemala,0,0,1,1
2953,2012,IRL,Ireland,3,1,1,5
2954,2012,ISL,Iceland,0,0,0,0
2955,2012,ISR,Israel,0,0,0,0
2956,2012,ISV,"Virgin Islands, US",0,0,0,0
2957,2012,ITA,Italy,30,16,22,68
2958,2012,IVB,"Virgin Islands, British",0,0,0,0
2959,2012,JAM,Jamaica,8,8,9,25
2960,2012,CYP,Cyprus,0,0,1,1
2961,2012,JPN,Japan,33,7,44,84
2962,2012,KAZ,Kazakhstan,5,7,1,13
2963,2012,KEN,Kenya,5,2,4,11
2964,2012,IRQ,Iraq,0,0,0,0
2965,2012,GRN,Grenada,0,1,0,1
2966,2012,JOR,Jordan,0,0,0,0
2967,2012,GHA,Ghana,0,0,0,0
2968,2012,GRE,Greece,3,0,0,3
2969,2012,DEN,Denmark,8,3,5,16
2970,2012,DMA,Dominica,0,0,0,0
2971,2012,DOM,Dominican Republic,0,1,1,2
2972,2012,ECU,Ecuador,0,0,0,0
2973,2012,EGY,Egypt,0,0,2,2
2974,2012,ERI,Eritrea,0,0,0,0
2975,2012,ESA,El Salvador,0,0,0,0
2976,2012,ESP,Spain,25,5,33,63
2977,2012,EST,Estonia,1,0,1,2
2978,2012,ETH,Ethiopia,3,3,1,7
2979,2012,DJI,Djibouti,0,0,0,0
2980,2012,FIN,Finland,4,0,1,5
2981,2012,FIJ,Fiji,0,0,0,0
2982,2012,GEQ,Equatorial Guinea,0,0,0,0
2983,2012,GEO,Georgia,3,1,3,7
2984,2012,GBS,Guinea-Bissau,0,0,0,0
2985,2012,GER,Germany,22,45,27,94
2986,2012,GAM,Gambia,0,0,0,0
2987,2012,GAB,Gabon,0,0,1,1
2988,2012,FSM,Micronesia,0,0,0,0
2989,2012,FRA,France,22,30,30,82
2990,2012,GBR,UK,48,48,30,126
2991,2014,PER,Peru,0,0,0,0
2992,2014,MNE,Montenegro,0,0,0,0
2993,2014,PAK,Pakistan,0,0,0,0
2994,2014,NZL,New Zealand,0,0,0,0
2995,2014,NOR,Norway,13,18,5,36
2996,2014,NEP,Nepal,0,0,0,0
2997,2014,NED,Netherlands,9,13,7,29
2998,2014,MON,Monaco,0,0,0,0
2999,2014,PAR,Paraguay,0,0,0,0
3000,2014,MDA,Moldova,0,0,0,0
3001,2014,MKD,Macedonia,0,0,0,0
3002,2014,MGL,Mongolia,0,0,0,0
3003,2014,MEX,Mexico,0,0,0,0
3004,2014,MAR,Morocco,0,0,0,0
3005,2014,LUX,Luxembourg,0,0,0,0
3006,2014,LTU,Lithuania,0,0,0,0
3007,2014,LIE,Liechtenstein,0,0,0,0
3008,2014,PHI,Philippines,0,0,0,0
3009,2014,LIB,Lebanon,0,0,0,0
3010,2014,MLT,Malta,0,0,0,0
3011,2014,POL,Poland,3,4,4,11
3012,2014,TJK,Tajikistan,0,0,0,0
3013,2014,ROU,Romania,0,0,0,0
3014,2014,LAT,Latvia,6,0,5,11
3015,2014,ZIM,Zimbabwe,0,0,0,0
3016,2014,VEN,Venezuela,0,0,0,0
3017,2014,UZB,Uzbekistan,0,0,0,0
3018,2014,USA,USA,24,10,30,64
3019,2014,UKR,Ukraine,1,4,0,5
3020,2014,TUR,Turkey,0,0,0,0
3021,2014,TPE,Taiwan,0,0,0,0
3022,2014,TOG,Togo,0,0,0,0
3023,2014,TLS,Timor-Leste,0,0,0,0
3024,2014,THA,Thailand,0,0,0,0
3025,2014,TGA,Tonga,0,0,0,0
3026,2014,SWE,Sweden,11,8,32,51
3027,2014,SVK,Slovakia,0,1,0,1
3028,2014,SUI,Switzerland,20,6,4,30
3029,2014,SRB,Serbia,0,0,0,0
3030,2014,SMR,San Marino,0,0,0,0
3031,2014,SLO,Slovenia,4,2,2,8
3032,2014,RUS,Russia,13,33,22,68
3033,2014,POR,Portugal,0,0,0,0
3034,2014,KOR,South Korea,2,7,5,14
3035,2014,KGZ,Kyrgyzstan,0,0,0,0
3036,2014,KAZ,Kazakhstan,1,0,0,1
3037,2014,CZE,Czech Republic,2,2,7,11
3038,2014,CYP,Cyprus,0,0,0,0
3039,2014,CRO,Croatia,0,0,1,1
3040,2014,CHN,China,5,3,4,12
3041,2014,CHI,Chile,0,0,0,0
3042,2014,CAY,Cayman Islands,0,0,0,0
3043,2014,CAN,Canada,5,59,22,86
3044,2014,BUL,Bulgaria,0,0,0,0
3045,2014,BRA,Brazil,0,0,0,0
3046,2014,BIH,Bosnia and Herzegovina,0,0,0,0
3047,2014,BER,Bermuda,0,0,0,0
3048,2014,BEL,Belgium,0,0,0,0
3049,2014,AZE,Azerbaijan,0,0,0,0
3050,2014,AUT,Austria,11,4,12,27
3051,2014,AUS,Australia,1,0,2,3
3052,2014,ARM,Armenia,0,0,0,0
3053,2014,ARG,Argentina,0,0,0,0
3054,2014,AND,Andorra,0,0,0,0
3055,2014,ALB,Albania,0,0,0,0
3056,2014,DEN,Denmark,0,0,0,0
3057,2014,DMA,Dominica,0,0,0,0
3058,2014,BLR,Belarus,1,5,0,6
3059,2014,EST,Estonia,0,0,0,0
3060,2014,ESP,Spain,0,0,0,0
3061,2014,JPN,Japan,6,1,4,11
3062,2014,JAM,Jamaica,0,0,0,0
3063,2014,IVB,"Virgin Islands, British",0,0,0,0
3064,2014,ITA,Italy,12,0,2,14
3065,2014,ISV,"Virgin Islands, US",0,0,0,0
3066,2014,ISL,Iceland,0,0,0,0
3067,2014,IRL,Ireland,0,0,0,0
3068,2014,IRI,Iran,0,0,0,0
3069,2014,IOA,Individual Olympic Athletes,0,0,0,0
3070,2014,ISR,Israel,0,0,0,0
3071,2014,IND,India,0,0,0,0
3072,2014,FRA,France,10,4,4,18
3073,2014,GBR,UK,5,1,4,10
3074,2014,GEO,Georgia,0,0,0,0
3075,2014,GER,Germany,9,15,12,36
3076,2014,FIN,Finland,24,2,7,33
3077,2014,HKG,China,0,0,0,0
3078,2014,HUN,Hungary,0,0,0,0
3079,2014,GRE,Greece,0,0,0,0
3080,2016,NGR,Nigeria,18,0,0,18
3081,2016,MOZ,Mozambique,0,0,0,0
3082,2016,MRI,Mauritius,0,0,0,0
3083,2016,MTN,Mauritania,0,0,0,0
3084,2016,MYA,Myanmar,0,0,0,0
3085,2016,NAM,Namibia,0,0,0,0
3086,2016,NCA,Nicaragua,0,0,0,0
3087,2016,NED,Netherlands,13,9,25,47
3088,2016,NEP,Nepal,0,0,0,0
3089,2016,NIG,Niger,0,0,1,1
3090,2016,PLW,Palau,0,0,0,0
3091,2016,NRU,Nauru,0,0,0,0
3092,2016,NZL,New Zealand,5,6,25,36
3093,2016,OMA,Oman,0,0,0,0
3094,2016,PAK,Pakistan,0,0,0,0
3095,2016,PAN,Panama,0,0,0,0
3096,2016,PAR,Paraguay,0,0,0,0
3097,2016,PER,Peru,0,0,0,0
3098,2016,PHI,Philippines,0,0,1,1
3099,2016,PLE,Palestine,0,0,0,0
3100,2016,MON,Monaco,0,0,0,0
3101,2016,NOR,Norway,19,0,0,19
3102,2016,MNE,Montenegro,0,0,0,0
3103,2016,LAO,Laos,0,0,0,0
3104,2016,MLI,Mali,0,0,0,0
3105,2016,KOS,Kosovo,0,1,0,1
3106,2016,KSA,Saudi Arabia,0,0,0,0
3107,2016,PNG,Papua New Guinea,0,0,0,0
3108,2016,LAT,Latvia,0,0,0,0
3109,2016,LBA,Libya,0,0,0,0
3110,2016,LBR,Liberia,0,0,0,0
3111,2016,LCA,Saint Lucia,0,0,0,0
3112,2016,LES,Lesotho,0,0,0,0
3113,2016,LIB,Lebanon,0,0,0,0
3114,2016,LIE,Liechtenstein,0,0,0,0
3115,2016,MLT,Malta,0,0,0,0
3116,2016,LTU,Lithuania,5,0,2,7
3117,2016,MAD,Madagascar,0,0,0,0
3118,2016,MAR,Morocco,1,0,0,1
3119,2016,MAS,Malaysia,1,0,7,8
3120,2016,MAW,Malawi,0,0,0,0
3121,2016,MDA,Moldova,0,0,0,0
3122,2016,MDV,Maldives,0,0,0,0
3123,2016,MEX,Mexico,2,0,3,5
3124,2016,MGL,Mongolia,1,0,1,2
3125,2016,MHL,Marshall Islands,0,0,0,0
3126,2016,MKD,Macedonia,0,0,0,0
3127,2016,LUX,Luxembourg,0,0,0,0
3128,2016,POL,Poland,10,3,3,16
3129,2016,SUD,Sudan,0,0,0,0
3130,2016,PRK,North Korea,2,2,3,7
3131,2016,TAN,Tanzania,0,0,0,0
3132,2016,TGA,Tonga,0,0,0,0
3133,2016,THA,Thailand,2,2,2,6
3134,2016,TJK,Tajikistan,0,1,0,1
3135,2016,TKM,Turkmenistan,0,0,0,0
3136,2016,TLS,Timor-Leste,0,0,0,0
3137,2016,TOG,Togo,0,0,0,0
3138,2016,TPE,Taiwan,4,1,0,5
3139,2016,TTO,Trinidad,1,0,0,1
3140,2016,TUN,Tunisia,3,0,0,3
3141,2016,SYR,Syria,0,0,0,0
3142,2016,TUR,Turkey,4,1,3,8
3143,2016,UGA,Uganda,0,0,0,0
3144,2016,UKR,Ukraine,5,2,8,15
3145,2016,URU,Uruguay,0,0,0,0
3146,2016,YEM,Yemen,0,0,0,0
3147,2016,USA,USA,71,139,54,8
3148,2016,UZB,Uzbekistan,7,4,2,13
3149,2016,VAN,Vanuatu,0,0,0,0
3150,2016,VEN,Venezuela,2,0,1,3
3151,2016,VIE,Vietnam,0,1,1,2
3152,2016,VIN,Saint Vincent,0,0,0,0
3153,2016,UAE,United Arab Emirates,1,0,0,1
3154,2016,POR,Portugal,1,0,0,1
3155,2016,SWZ,Swaziland,0,0,0,0
3156,2016,SVK,Slovakia,0,3,5,8
3157,2016,PUR,Puerto Rico,0,1,0,1
3158,2016,QAT,Qatar,0,0,1,1
3159,2016,ROU,Romania,10,4,2,16
3160,2016,RSA,South Africa,14,2,7,23
3161,2016,RUS,Russia,35,52,28,115
3162,2016,RWA,Rwanda,0,0,0,0
3163,2016,SAM,Samoa,0,0,0,0
3164,2016,SEN,Senegal,0,0,0,0
3165,2016,SEY,Seychelles,0,0,0,0
3166,2016,SKN,Saint Kitts,0,0,0,0
3167,2016,SWE,Sweden,3,2,23,28
3168,2016,SLE,Sierra Leone,0,0,0,0
3169,2016,SMR,San Marino,0,0,0,0
3170,2016,SOL,Solomon Islands,0,0,0,0
3171,2016,SOM,Somalia,0,0,0,0
3172,2016,SRB,Serbia,13,14,27,54
3173,2016,SRI,Sri Lanka,0,0,0,0
3174,2016,SSD,South Sudan,0,0,0,0
3175,2016,STP,Sao Tome and Principe,0,0,0,0
3176,2016,KOR,South Korea,10,13,3,26
3177,2016,SUI,Switzerland,2,6,3,11
3178,2016,SUR,Suriname,0,0,0,0
3179,2016,SLO,Slovenia,1,1,2,4
3180,2016,KIR,Kiribati,0,0,0,0
3181,2016,ARG,Argentina,0,21,1,22
3182,2016,KEN,Kenya,1,6,6,13
3183,2016,BRA,Brazil,6,36,8,50
3184,2016,BRN,Bahrain,0,1,1,2
3185,2016,BRU,Brunei,0,0,0,0
3186,2016,BUL,Bulgaria,6,0,1,7
3187,2016,BUR,Burkina Faso,0,0,0,0
3188,2016,CAF,Central African Republic,0,0,0,0
3189,2016,CAM,Cambodia,0,0,0,0
3190,2016,CAN,Canada,61,4,4,69
3191,2016,CAY,Cayman Islands,0,0,0,0
3192,2016,CGO,Republic of Congo,0,0,0,0
3193,2016,CHA,Chad,0,0,0,0
3194,2016,CHI,Chile,0,0,0,0
3195,2016,CHN,China,37,46,30,113
3196,2016,CIV,Ivory Coast,1,1,0,2
3197,2016,CMR,Cameroon,0,0,0,0
3198,2016,COD,Democratic Republic of the Congo,0,0,0,0
3199,2016,COK,Cook Islands,0,0,0,0
3200,2016,COL,Colombia,3,3,2,8
3201,2016,COM,Comoros,0,0,0,0
3202,2016,CPV,Cape Verde,0,0,0,0
3203,2016,CRC,Costa Rica,0,0,0,0
3204,2016,BOT,Botswana,0,0,0,0
3205,2016,BOL,Boliva,0,0,0,0
3206,2016,BLR,Belarus,7,1,4,12
3207,2016,BIZ,Belize,0,0,0,0
3208,2016,ZAM,Zambia,0,0,0,0
3209,2016,AFG,Afghanistan,0,0,0,0
3210,2016,ALB,Albania,0,0,0,0
3211,2016,ALG,Algeria,0,0,2,2
3212,2016,AND,Andorra,0,0,0,0
3213,2016,ANG,Angola,0,0,0,0
3214,2016,ANT,Antigua,0,0,0,0
3215,2016,ARM,Armenia,0,1,3,4
3216,2016,ARU,Aruba,0,0,0,0
3217,2016,ASA,American Samoa,0,0,0,0
3218,2016,CRO,Croatia,2,7,15,24
3219,2016,AUS,Australia,25,23,34,82
3220,2016,AZE,Azerbaijan,10,1,7,18
3221,2016,BAH,Bahamas,5,1,0,6
3222,2016,BAN,Bangladesh,0,0,0,0
3223,2016,BAR,Barbados,0,0,0,0
3224,2016,BDI,Burundi,0,0,1,1
3225,2016,BEL,Belgium,2,2,17,21
3226,2016,BEN,Benin,0,0,0,0
3227,2016,BER,Bermuda,0,0,0,0
3228,2016,BHU,Bhutan,0,0,0,0
3229,2016,BIH,Bosnia and Herzegovina,0,0,0,0
3230,2016,AUT,Austria,2,0,0,2
3231,2016,CUB,Cuba,4,5,2,11
3232,2016,CYP,Cyprus,0,0,0,0
3233,2016,CZE,Czech Republic,12,1,2,15
3234,2016,GUI,Guinea,0,0,0,0
3235,2016,GUM,Guam,0,0,0,0
3236,2016,GUY,Guyana,0,0,0,0
3237,2016,HAI,Haiti,0,0,0,0
3238,2016,HKG,China,0,0,0,0
3239,2016,HON,Honduras,0,0,0,0
3240,2016,HUN,Hungary,7,12,3,22
3241,2016,INA,Indonesia,0,2,2,4
3242,2016,IND,India,1,0,1,2
3243,2016,IOA,Individual Olympic Athletes,1,1,0,2
3244,2016,GUA,Guatemala,0,0,0,0
3245,2016,IRI,Iran,4,3,1,8
3246,2016,IRQ,Iraq,0,0,0,0
3247,2016,ISL,Iceland,0,0,0,0
3248,2016,ISR,Israel,2,0,0,2
3249,2016,ISV,"Virgin Islands, US",0,0,0,0
3250,2016,ITA,Italy,24,8,40,72
3251,2016,IVB,"Virgin Islands, British",0,0,0,0
3252,2016,JAM,Jamaica,2,11,17,30
3253,2016,JOR,Jordan,0,1,0,1
3254,2016,JPN,Japan,34,17,13,64
3255,2016,KAZ,Kazakhstan,10,3,5,18
3256,2016,IRL,Ireland,0,0,3,3
3257,2016,KGZ,Kyrgyzstan,0,0,0,0
3258,2016,GRN,Grenada,0,0,1,1
3259,2016,GHA,Ghana,0,0,0,0
3260,2016,DEN,Denmark,16,15,10,41
3261,2016,DJI,Djibouti,0,0,0,0
3262,2016,DMA,Dominica,0,0,0,0
3263,2016,DOM,Dominican Republic,1,0,0,1
3264,2016,ECU,Ecuador,0,0,0,0
3265,2016,EGY,Egypt,3,0,0,3
3266,2016,ERI,Eritrea,0,0,0,0
3267,2016,ESA,El Salvador,0,0,0,0
3268,2016,ESP,Spain,17,9,19,45
3269,2016,EST,Estonia,4,0,0,4
3270,2016,GRE,Greece,3,3,1,7
3271,2016,ETH,Ethiopia,5,1,2,8
3272,2016,FIN,Finland,1,0,0,1
3273,2016,FRA,France,21,20,55,96
3274,2016,FSM,Micronesia,0,0,0,0
3275,2016,GAB,Gabon,0,0,0,0
3276,2016,GAM,Gambia,0,0,0,0
3277,2016,GBR,UK,26,64,55,145
3278,2016,GBS,Guinea-Bissau,0,0,0,0
3279,2016,GEO,Georgia,4,2,1,7
3280,2016,GEQ,Equatorial Guinea,0,0,0,0
3281,2016,GER,Germany,67,49,43,159
3282,2016,FIJ,Fiji,0,13,0,13
3283,2016,ZIM,Zimbabwe,0,0,0,0
3284,2021,JPN,Japan,17,27,14,58
3285,2021,ANZ,Australia,22,17,7,46
3286,2021,AUS,Australia,22,17,7,46
3287,2021,NED,Netherlands,14,10,12,36
3288,2021,FRA,France,11,10,12,33
3289,2021,FRG,Germany,16,10,11,37
3290,2021,GDR,Germany,16,10,11,37
3291,2021,GER,Germany,16,10,11,37
3292,2021,SAA,Germany,16,10,11,37
3293,2021,ITA,Italy,20,10,10,40
3294,2021,CAN,Canada,11,7,6,24
3295,2021,NFL,Canada,11,7,6,24
3296,2021,BRA,Brazil,8,7,6,21
3297,2021,NZL,New Zealand,7,7,6,20
3298,2021,CUB,Cuba,5,7,3,15
3299,2021,HUN,Hungary,7,6,7,20
3300,2021,POL,Poland,5,4,5,14
3301,2021,BOH,Czech Republic,3,4,4,11
3302,2021,CZE,Czech Republic,3,4,4,11
3303,2021,TCH,Czech Republic,3,4,4,11
3304,2021,KEN,Kenya,2,4,4,10
3305,2021,NOR,Norway,2,4,2,8
3306,2021,JAM,Jamaica,4,4,1,9
3307,2021,ESP,Spain,6,3,8,17
3308,2021,SWE,Sweden,0,3,6,9
3309,2021,SUI,Switzerland,6,3,4,13
3310,2021,DEN,Denmark,4,3,4,11
3311,2021,CRO,Croatia,2,3,3,8
3312,2021,SCG,Serbia,5,3,1,9
3313,2021,SRB,Serbia,5,3,1,9
3314,2021,YUG,Serbia,5,3,1,9
3315,2021,BEL,Belgium,3,3,1,7
3316,2021,BUL,Bulgaria,2,3,1,6
3317,2021,SLO,Slovenia,1,3,1,5
3318,2021,UZB,Uzbekistan,2,3,0,5
3319,2021,GEO,Georgia,1,2,5,8
3320,2021,TUR,Turkey,9,2,2,13
3321,2021,CRT,Greece,1,2,1,4
3322,2021,GRE,Greece,1,2,1,4
3323,2021,UGA,Uganda,1,2,1,4
3324,2021,ECU,Ecuador,0,2,1,3
3325,2021,IRL,Ireland,2,2,0,4
3326,2021,ISR,Israel,2,2,0,4
3327,2021,QAT,Qatar,1,2,0,3
3328,2021,BAH,Bahamas,0,2,0,2
3329,2021,KOS,Kosovo,0,2,0,2
3330,2021,UKR,Ukraine,12,1,6,19
3331,2021,BLR,Belarus,3,1,3,7
3332,2021,ROU,Romania,0,1,3,4
3333,2021,VEN,Venezuela,0,1,3,4
3334,2021,IND,India,4,1,2,7
3335,2021,PHI,Philippines,1,1,2,4
3336,2021,SVK,Slovakia,1,1,2,4
3337,2021,RSA,South Africa,0,1,2,3
3338,2021,AUT,Austria,5,1,1,7
3339,2021,EGY,Egypt,4,1,1,6
3340,2021,INA,Indonesia,3,1,1,5
3341,2021,ETH,Ethiopia,2,1,1,4
3342,2021,POR,Portugal,2,1,1,4
3343,2021,TUN,Tunisia,0,1,1,2
3344,2021,EST,Estonia,1,1,0,2
3345,2021,FIJ,Fiji,1,1,0,2
3346,2021,LAT,Latvia,1,1,0,2
3347,2021,THA,Thailand,1,1,0,2
3348,2021,BER,Bermuda,0,1,0,1
3349,2021,MAR,Morocco,0,1,0,1
3350,2021,PUR,Puerto Rico,0,1,0,1
3351,2021,COL,Colombia,1,0,4,5
3352,2021,AZE,Azerbaijan,4,0,3,7
3353,2021,DOM,Dominican Republic,2,0,3,5
3354,2021,ARM,Armenia,2,0,2,4
3355,2021,KGZ,Kyrgyzstan,1,0,2,3
3356,2021,MGL,Mongolia,3,0,1,4
3357,2021,ARG,Argentina,2,0,1,3
3358,2021,SMR,San Marino,2,0,1,3
3359,2021,JOR,Jordan,1,0,1,2
3360,2021,MAL,Malaysia,1,0,1,2
3361,2021,MAS,Malaysia,1,0,1,2
3362,2021,NBO,Malaysia,1,0,1,2
3363,2021,NGR,Nigeria,1,0,1,2
3364,2021,BRN,Bahrain,0,0,1,1
3365,2021,KSA,Saudi Arabia,0,0,1,1
3366,2021,LTU,Lithuania,0,0,1,1
3367,2021,NAM,Namibia,0,0,1,1
3368,2021,TKM,Turkmenistan,0,0,1,1
3369,2021,KAZ,Kazakhstan,8,0,0,8
3370,2021,MEX,Mexico,4,0,0,4
3371,2021,FIN,Finland,2,0,0,2
3372,2021,BOT,Botswana,1,0,0,1
3373,2021,BUR,Burkina Faso,1,0,0,1
3374,2021,GHA,Ghana,1,0,0,1
3375,2021,GRN,Grenada,1,0,0,1
3376,2021,KUW,Kuwait,1,0,0,1
